year,migration_type,primary_FIPS,primary_county,aux_FIPS,aux_county,aux_state,aux_GeoRollup,people_inflow,agi_inflow,agi_capita_inflow,people_outflow,agi_outflow,agi_capita_outflow,people_net,agi_net
2016,county,48439,Tarrant,16001,Ada,ID,Rural Idaho,53,1169000,22056.603773584906,62,2018000,32548.387096774193,-9,-849000
2016,county,48113,Dallas,16001,Ada,ID,Rural Idaho,31,902000,29096.774193548386,62,2685000,43306.45161290323,-31,-1783000
2016,county,48439,Tarrant,08001,Adams,CO,Denver,106,2768000,26113.20754716981,110,2999000,27263.636363636364,-4,-231000
2016,county,48113,Dallas,08001,Adams,CO,Denver,93,2541000,27322.58064516129,89,2666000,29955.05617977528,4,-125000
2016,county,48121,Denton,08001,Adams,CO,Denver,76,2962000,38973.68421052631,36,1666000,46277.77777777778,40,1296000
2016,county,48439,Tarrant,06001,Alameda,CA,Bay Area,153,5695000,37222.22222222222,131,4632000,35358.7786259542,22,1063000
2016,county,48113,Dallas,06001,Alameda,CA,Bay Area,350,15420000,44057.142857142855,206,10652000,51708.73786407767,144,4768000
2016,county,48121,Denton,06001,Alameda,CA,Bay Area,187,8071000,43160.42780748663,55,2757000,50127.27272727273,132,5314000
2016,county,48085,Collin,06001,Alameda,CA,Bay Area,308,15790000,51266.23376623377,161,7903000,49086.95652173913,147,7887000
2016,county,48113,Dallas,51510,Alexandria city,VA,D.C.,54,3826000,70851.85185185185,52,3837000,73788.46153846153,2,-11000
2016,county,48439,Tarrant,42003,Allegheny,PA,Pittsburgh,279,22657000,81207.8853046595,77,3041000,39493.506493506495,202,19616000
2016,county,48113,Dallas,42003,Allegheny,PA,Pittsburgh,142,5856000,41239.43661971831,122,4767000,39073.770491803276,20,1089000
2016,county,48085,Collin,42003,Allegheny,PA,Pittsburgh,90,4680000,52000.0,36,2336000,64888.88888888889,54,2344000
2016,county,48113,Dallas,18003,Allen,IN,Rural Indiana,61,1687000,27655.737704918032,89,1955000,21966.29213483146,-28,-268000
2016,county,48439,Tarrant,02020,Anchorage Borough,AK,Rural Alaska,74,1911000,25824.324324324323,68,1550000,22794.117647058825,6,361000
2016,county,48439,Tarrant,48001,Anderson,TX,Rural Texas,84,1486000,17690.47619047619,72,1863000,25875.0,12,-377000
2016,county,48113,Dallas,48001,Anderson,TX,Rural Texas,128,1898000,14828.125,141,2285000,16205.673758865249,-13,-387000
2016,county,48113,Dallas,48005,Angelina,TX,Rural Texas,123,1952000,15869.918699186992,50,829000,16580.0,73,1123000
2016,county,48439,Tarrant,24003,Anne Arundel,MD,Baltimore,73,4197000,57493.150684931505,62,1493000,24080.645161290322,11,2704000
2016,county,48113,Dallas,24003,Anne Arundel,MD,Baltimore,63,2486000,39460.31746031746,47,2503000,53255.31914893617,16,-17000
2016,county,48439,Tarrant,08005,Arapahoe,CO,Denver,183,5105000,27896.17486338798,146,5828000,39917.808219178085,37,-723000
2016,county,48113,Dallas,08005,Arapahoe,CO,Denver,214,7483000,34967.28971962617,255,16720000,65568.62745098039,-41,-9237000
2016,county,48121,Denton,08005,Arapahoe,CO,Denver,79,3481000,44063.29113924051,65,2357000,36261.53846153846,14,1124000
2016,county,48085,Collin,08005,Arapahoe,CO,Denver,174,5780000,33218.3908045977,118,4994000,42322.03389830508,56,786000
2016,county,48439,Tarrant,51013,Arlington,VA,D.C.,44,2174000,49409.09090909091,35,2051000,58600.0,9,123000
2016,county,48113,Dallas,51013,Arlington,VA,D.C.,109,7963000,73055.04587155963,64,4770000,74531.25,45,3193000
2016,county,48439,Tarrant,24005,Baltimore,MD,Baltimore,103,2186000,21223.300970873788,35,1024000,29257.14285714286,68,1162000
2016,county,48113,Dallas,24005,Baltimore,MD,Baltimore,99,2952000,29818.18181818182,46,2122000,46130.434782608696,53,830000
2016,county,48113,Dallas,24510,Baltimore city,MD,Baltimore,86,2802000,32581.39534883721,48,2209000,46020.833333333336,38,593000
2016,county,48439,Tarrant,45013,Beaufort,SC,Savannah,49,1245000,25408.163265306124,50,2163000,43260.0,-1,-918000
2016,county,48439,Tarrant,48027,Bell,TX,Rural Texas,630,16708000,26520.634920634922,465,8738000,18791.397849462366,165,7970000
2016,county,48113,Dallas,48027,Bell,TX,Rural Texas,540,12826000,23751.85185185185,370,8092000,21870.27027027027,170,4734000
2016,county,48121,Denton,48027,Bell,TX,Rural Texas,213,5781000,27140.845070422536,159,4161000,26169.811320754718,54,1620000
2016,county,48085,Collin,48027,Bell,TX,Rural Texas,229,7049000,30781.659388646287,157,3861000,24592.35668789809,72,3188000
2016,county,48439,Tarrant,05007,Benton,AR,Rural Arkansas,116,3216000,27724.137931034482,197,8059000,40908.62944162437,-81,-4843000
2016,county,48113,Dallas,05007,Benton,AR,Rural Arkansas,132,7676000,58151.51515151515,147,6144000,41795.91836734694,-15,1532000
2016,county,48121,Denton,05007,Benton,AR,Rural Arkansas,82,4556000,55560.9756097561,97,4316000,44494.845360824744,-15,240000
2016,county,48085,Collin,05007,Benton,AR,Rural Arkansas,150,9094000,60626.666666666664,137,5571000,40664.233576642335,13,3523000
2016,county,48439,Tarrant,34003,Bergen,NJ,New York,79,2949000,37329.11392405063,36,1714000,47611.11111111111,43,1235000
2016,county,48113,Dallas,34003,Bergen,NJ,New York,125,5829000,46632.0,83,5007000,60325.301204819276,42,822000
2016,county,48085,Collin,34003,Bergen,NJ,New York,112,4147000,37026.78571428572,124,9702000,78241.93548387097,-12,-5555000
2016,county,48439,Tarrant,35001,Bernalillo,NM,Albuquerque,171,5882000,34397.66081871345,151,3938000,26079.470198675495,20,1944000
2016,county,48113,Dallas,35001,Bernalillo,NM,Albuquerque,161,5195000,32267.080745341616,170,4397000,25864.70588235294,-9,798000
2016,county,48085,Collin,35001,Bernalillo,NM,Albuquerque,96,4911000,51156.25,72,2736000,38000.0,24,2175000
2016,county,48439,Tarrant,48029,Bexar,TX,San Antonio,1239,37196000,30020.984665052463,1034,29400000,28433.268858800773,205,7796000
2016,county,48113,Dallas,48029,Bexar,TX,San Antonio,1528,52756000,34526.1780104712,1215,41206000,33914.40329218107,313,11550000
2016,county,48121,Denton,48029,Bexar,TX,San Antonio,566,25392000,44862.19081272085,450,13926000,30946.666666666668,116,11466000
2016,county,48085,Collin,48029,Bexar,TX,San Antonio,658,27360000,41580.54711246201,459,17333000,37762.52723311547,199,10027000
2016,county,48439,Tarrant,48035,Bosque,TX,Rural Texas,83,2321000,27963.85542168675,73,2173000,29767.12328767123,10,148000
2016,county,48439,Tarrant,22015,Bossier Parish,LA,Rural Louisiana,190,4865000,25605.263157894737,76,2334000,30710.526315789473,114,2531000
2016,county,48113,Dallas,22015,Bossier Parish,LA,Rural Louisiana,141,2515000,17836.879432624115,89,1841000,20685.393258426968,52,674000
2016,county,48121,Denton,22015,Bossier Parish,LA,Rural Louisiana,57,1437000,25210.526315789473,47,937000,19936.17021276596,10,500000
2016,county,48085,Collin,22015,Bossier Parish,LA,Rural Louisiana,47,1790000,38085.10638297872,28,1022000,36500.0,19,768000
2016,county,48439,Tarrant,08013,Boulder,CO,Denver,43,2861000,66534.88372093023,66,2650000,40151.51515151515,-23,211000
2016,county,48113,Dallas,08013,Boulder,CO,Denver,45,1969000,43755.555555555555,97,12048000,124206.18556701031,-52,-10079000
2016,county,48085,Collin,08013,Boulder,CO,Denver,39,3427000,87871.79487179487,49,3044000,62122.448979591834,-10,383000
2016,county,48439,Tarrant,48037,Bowie,TX,Rural Texas,146,3210000,21986.301369863013,94,2227000,23691.489361702126,52,983000
2016,county,48113,Dallas,48037,Bowie,TX,Rural Texas,176,2793000,15869.318181818182,172,3681000,21401.162790697676,4,-888000
2016,county,48121,Denton,48037,Bowie,TX,Rural Texas,76,1820000,23947.36842105263,41,951000,23195.121951219513,35,869000
2016,county,48085,Collin,48037,Bowie,TX,Rural Texas,55,1598000,29054.545454545456,48,1580000,32916.666666666664,7,18000
2016,county,48439,Tarrant,48039,Brazoria,TX,Houston,122,3595000,29467.213114754097,149,4664000,31302.013422818793,-27,-1069000
2016,county,48113,Dallas,48039,Brazoria,TX,Houston,160,5158000,32237.5,149,3923000,26328.859060402683,11,1235000
2016,county,48121,Denton,48039,Brazoria,TX,Houston,94,2617000,27840.425531914894,98,2425000,24744.897959183672,-4,192000
2016,county,48085,Collin,48039,Brazoria,TX,Houston,89,2949000,33134.831460674155,49,3262000,66571.42857142857,40,-313000
2016,county,48439,Tarrant,48041,Brazos,TX,Rural Texas,299,7609000,25448.16053511706,183,4350000,23770.491803278688,116,3259000
2016,county,48113,Dallas,48041,Brazos,TX,Rural Texas,315,8709000,27647.619047619046,250,6925000,27700.0,65,1784000
2016,county,48121,Denton,48041,Brazos,TX,Rural Texas,154,3647000,23681.81818181818,130,3568000,27446.153846153848,24,79000
2016,county,48085,Collin,48041,Brazos,TX,Rural Texas,157,4636000,29528.662420382167,116,3648000,31448.275862068964,41,988000
2016,county,48439,Tarrant,12009,Brevard,FL,Atlantic Coast,56,2702000,48250.0,85,2987000,35141.17647058824,-29,-285000
2016,county,48113,Dallas,12009,Brevard,FL,Atlantic Coast,37,644000,17405.405405405407,36,1679000,46638.88888888889,1,-1035000
2016,county,48085,Collin,12009,Brevard,FL,Atlantic Coast,57,2125000,37280.70175438596,52,3025000,58173.07692307692,5,-900000
2016,county,48113,Dallas,36005,Bronx,NY,New York,109,2041000,18724.770642201835,34,632000,18588.235294117647,75,1409000
2016,county,48439,Tarrant,12011,Broward,FL,Miami,268,8211000,30638.059701492537,175,7327000,41868.57142857143,93,884000
2016,county,48113,Dallas,12011,Broward,FL,Miami,334,14720000,44071.85628742515,277,20208000,72953.06859205777,57,-5488000
2016,county,48121,Denton,12011,Broward,FL,Miami,143,5394000,37720.27972027972,78,5823000,74653.84615384616,65,-429000
2016,county,48085,Collin,12011,Broward,FL,Miami,188,7627000,40569.14893617021,146,7304000,50027.397260273974,42,323000
2016,county,48439,Tarrant,48049,Brown,TX,Rural Texas,49,724000,14775.510204081633,98,2464000,25142.85714285714,-49,-1740000
2016,county,48439,Tarrant,40013,Bryan,OK,Rural Oklahoma,63,1739000,27603.174603174604,47,906000,19276.59574468085,16,833000
2016,county,48113,Dallas,40013,Bryan,OK,Rural Oklahoma,36,640000,17777.777777777777,41,649000,15829.268292682927,-5,-9000
2016,county,48085,Collin,40013,Bryan,OK,Rural Oklahoma,51,1084000,21254.901960784315,74,1215000,16418.91891891892,-23,-131000
2016,county,48439,Tarrant,34005,Burlington,NJ,Philadelphia,92,2495000,27119.565217391304,51,1242000,24352.941176470587,41,1253000
2016,county,48439,Tarrant,22017,Caddo Parish,LA,Rural Louisiana,412,6720000,16310.679611650485,148,2338000,15797.297297297297,264,4382000
2016,county,48113,Dallas,22017,Caddo Parish,LA,Rural Louisiana,537,8677000,16158.28677839851,240,5927000,24695.833333333332,297,2750000
2016,county,48085,Collin,22017,Caddo Parish,LA,Rural Louisiana,133,2986000,22451.127819548874,41,995000,24268.29268292683,92,1991000
2016,county,48439,Tarrant,22019,Calcasieu Parish,LA,Rural Louisiana,39,590000,15128.205128205129,61,1441000,23622.950819672133,-22,-851000
2016,county,48113,Dallas,22019,Calcasieu Parish,LA,Rural Louisiana,63,1764000,28000.0,61,1092000,17901.639344262294,2,672000
2016,county,48439,Tarrant,48061,Cameron,TX,Rural Texas,153,2722000,17790.849673202614,131,6128000,46778.62595419848,22,-3406000
2016,county,48113,Dallas,48061,Cameron,TX,Rural Texas,251,3852000,15346.613545816734,193,4390000,22746.113989637306,58,-538000
2016,county,48121,Denton,48061,Cameron,TX,Rural Texas,67,1660000,24776.119402985074,44,1044000,23727.272727272728,23,616000
2016,county,48439,Tarrant,40017,Canadian,OK,Oklahoma City,80,2986000,37325.0,119,3867000,32495.798319327732,-39,-881000
2016,county,48113,Dallas,40017,Canadian,OK,Oklahoma City,28,1070000,38214.28571428572,48,1149000,23937.5,-20,-79000
2016,county,48439,Tarrant,40019,Carter,OK,Rural Oklahoma,38,514000,13526.315789473685,55,806000,14654.545454545454,-17,-292000
2016,county,48113,Dallas,48067,Cass,TX,Rural Texas,38,906000,23842.105263157893,40,1237000,30925.0,-2,-331000
2016,county,48113,Dallas,45019,Charleston,SC,Charleston,44,1518000,34500.0,49,1548000,31591.836734693876,-5,-30000
2016,county,48439,Tarrant,13051,Chatham,GA,Savannah,80,2454000,30675.0,40,703000,17575.0,40,1751000
2016,county,48439,Tarrant,48073,Cherokee,TX,Rural Texas,73,1183000,16205.479452054795,59,1745000,29576.271186440677,14,-562000
2016,county,48113,Dallas,48073,Cherokee,TX,Rural Texas,45,605000,13444.444444444445,73,1996000,27342.465753424658,-28,-1391000
2016,county,48439,Tarrant,32003,Clark,NV,Las Vegas,469,13357000,28479.744136460555,361,9070000,25124.65373961219,108,4287000
2016,county,48113,Dallas,32003,Clark,NV,Las Vegas,476,13317000,27976.89075630252,367,19615000,53446.86648501363,109,-6298000
2016,county,48121,Denton,32003,Clark,NV,Las Vegas,181,5933000,32779.00552486188,140,8448000,60342.857142857145,41,-2515000
2016,county,48085,Collin,32003,Clark,NV,Las Vegas,308,18469000,59964.28571428572,157,4774000,30407.64331210191,151,13695000
2016,county,48439,Tarrant,29047,Clay,MO,Kansas City,82,2456000,29951.219512195123,38,1109000,29184.21052631579,44,1347000
2016,county,48439,Tarrant,13063,Clayton,GA,Atlanta,45,561000,12466.666666666666,51,498000,9764.70588235294,-6,63000
2016,county,48439,Tarrant,40027,Cleveland,OK,Oklahoma City,168,4911000,29232.14285714286,184,5611000,30494.565217391304,-16,-700000
2016,county,48113,Dallas,40027,Cleveland,OK,Oklahoma City,166,5242000,31578.31325301205,139,4536000,32633.093525179855,27,706000
2016,county,48121,Denton,40027,Cleveland,OK,Oklahoma City,79,1668000,21113.92405063291,77,1760000,22857.14285714286,2,-92000
2016,county,48085,Collin,40027,Cleveland,OK,Oklahoma City,115,3086000,26834.782608695652,82,2387000,29109.756097560974,33,699000
2016,county,48439,Tarrant,13067,Cobb,GA,Atlanta,201,7438000,37004.97512437811,152,6414000,42197.36842105263,49,1024000
2016,county,48113,Dallas,13067,Cobb,GA,Atlanta,223,16015000,71816.14349775785,170,6773000,39841.17647058824,53,9242000
2016,county,48121,Denton,13067,Cobb,GA,Atlanta,117,6433000,54982.905982905984,75,3407000,45426.666666666664,42,3026000
2016,county,48085,Collin,13067,Cobb,GA,Atlanta,117,5056000,43213.67521367521,95,3408000,35873.68421052631,22,1648000
2016,county,48439,Tarrant,12021,Collier,FL,S.W. Florida,44,1424000,32363.636363636364,65,8997000,138415.38461538462,-21,-7573000
2016,county,48113,Dallas,12021,Collier,FL,S.W. Florida,48,1244000,25916.666666666668,67,7326000,109343.28358208956,-19,-6082000
2016,county,48439,Tarrant,48085,Collin,TX,Dallas-Fort Worth,2481,89009000,35876.25957275292,2677,92641000,34606.275681733285,-196,-3632000
2016,county,48113,Dallas,48085,Collin,TX,Dallas-Fort Worth,15244,646443000,42406.389399107844,21294,863175000,40536.06649760496,-6050,-216732000
2016,county,48121,Denton,48085,Collin,TX,Dallas-Fort Worth,12431,546787000,43985.761402944256,9732,390844000,40160.706946157006,2699,155943000
2016,county,48439,Tarrant,48091,Comal,TX,San Antonio,99,2740000,27676.76767676768,181,7852000,43381.21546961326,-82,-5112000
2016,county,48113,Dallas,48091,Comal,TX,San Antonio,52,1864000,35846.153846153844,102,4040000,39607.8431372549,-50,-2176000
2016,county,48121,Denton,48091,Comal,TX,San Antonio,76,2523000,33197.36842105263,94,4648000,49446.8085106383,-18,-2125000
2016,county,48439,Tarrant,40031,Comanche,OK,Rural Oklahoma,135,2978000,22059.25925925926,93,1991000,21408.602150537634,42,987000
2016,county,48113,Dallas,40031,Comanche,OK,Rural Oklahoma,100,2775000,27750.0,58,1066000,18379.310344827587,42,1709000
2016,county,48439,Tarrant,06013,Contra Costa,CA,Bay Area,123,5068000,41203.25203252032,60,4243000,70716.66666666667,63,825000
2016,county,48113,Dallas,06013,Contra Costa,CA,Bay Area,162,7142000,44086.41975308642,105,4838000,46076.19047619047,57,2304000
2016,county,48085,Collin,06013,Contra Costa,CA,Bay Area,145,6192000,42703.44827586207,79,4496000,56911.39240506329,66,1696000
2016,county,48439,Tarrant,17031,Cook,IL,Chicago,886,48883000,55172.686230248306,371,11797000,31797.843665768192,515,37086000
2016,county,48113,Dallas,17031,Cook,IL,Chicago,1471,63371000,43080.217539089055,705,34767000,49314.89361702128,766,28604000
2016,county,48121,Denton,17031,Cook,IL,Chicago,341,12192000,35753.66568914956,132,4367000,33083.333333333336,209,7825000
2016,county,48085,Collin,17031,Cook,IL,Chicago,802,31055000,38721.945137157105,206,7418000,36009.70873786408,596,23637000
2016,county,48439,Tarrant,48097,Cooke,TX,Rural Texas,108,3902000,36129.62962962963,118,3350000,28389.830508474577,-10,552000
2016,county,48113,Dallas,48097,Cooke,TX,Rural Texas,79,2754000,34860.759493670885,112,4257000,38008.92857142857,-33,-1503000
2016,county,48121,Denton,48097,Cooke,TX,Rural Texas,493,13144000,26661.25760649087,782,20479000,26187.979539641943,-289,-7335000
2016,county,48085,Collin,48097,Cooke,TX,Rural Texas,49,1536000,31346.938775510203,82,3833000,46743.90243902439,-33,-2297000
2016,county,48439,Tarrant,48099,Coryell,TX,Rural Texas,98,1652000,16857.14285714286,81,1459000,18012.345679012345,17,193000
2016,county,48113,Dallas,48099,Coryell,TX,Rural Texas,67,1250000,18656.716417910447,63,1121000,17793.650793650795,4,129000
2016,county,48439,Tarrant,37051,Cumberland,NC,Rural North Carolina,108,1578000,14611.111111111111,48,895000,18645.833333333332,60,683000
2016,county,48113,Dallas,37051,Cumberland,NC,Rural North Carolina,96,1431000,14906.25,48,778000,16208.333333333334,48,653000
2016,county,48439,Tarrant,39035,Cuyahoga,OH,Cleveland,129,3941000,30550.387596899225,44,1812000,41181.818181818184,85,2129000
2016,county,48113,Dallas,39035,Cuyahoga,OH,Cleveland,152,7286000,47934.21052631579,111,5055000,45540.54054054054,41,2231000
2016,county,48085,Collin,39035,Cuyahoga,OH,Cleveland,107,3635000,33971.96261682243,63,6807000,108047.61904761905,44,-3172000
2016,county,48439,Tarrant,27037,Dakota,MN,Minneapolis,79,3310000,41898.73417721519,41,1223000,29829.268292682926,38,2087000
2016,county,48113,Dallas,27037,Dakota,MN,Minneapolis,82,3148000,38390.243902439026,47,1525000,32446.808510638297,35,1623000
2016,county,48439,Tarrant,48113,Dallas,TX,Dallas-Fort Worth,23251,635272000,27322.35172680745,18852,494549000,26233.23785274772,4399,140723000
2016,county,48121,Denton,48113,Dallas,TX,Dallas-Fort Worth,16347,598499000,36612.16125282927,11519,380855000,33063.19993054953,4828,217644000
2016,county,48085,Collin,48113,Dallas,TX,Dallas-Fort Worth,21294,863175000,40536.06649760496,15244,646443000,42406.389399107844,6050,216732000
2016,county,48439,Tarrant,55025,Dane,WI,Madison,56,1841000,32875.0,37,1676000,45297.2972972973,19,165000
2016,county,48113,Dallas,55025,Dane,WI,Madison,89,3667000,41202.247191011236,57,1911000,33526.31578947369,32,1756000
2016,county,48085,Collin,55025,Dane,WI,Madison,57,2468000,43298.245614035084,48,1543000,32145.833333333332,9,925000
2016,county,48439,Tarrant,47037,Davidson,TN,Nashville,157,5013000,31929.936305732484,99,3600000,36363.63636363636,58,1413000
2016,county,48113,Dallas,47037,Davidson,TN,Nashville,259,11786000,45505.79150579151,214,11149000,52098.13084112149,45,637000
2016,county,48121,Denton,47037,Davidson,TN,Nashville,49,1552000,31673.469387755104,32,1806000,56437.5,17,-254000
2016,county,48085,Collin,47037,Davidson,TN,Nashville,92,3224000,35043.47826086957,73,3180000,43561.643835616436,19,44000
2016,county,48439,Tarrant,49011,Davis,UT,Rural Utah,54,1368000,25333.333333333332,54,1218000,22555.555555555555,0,150000
2016,county,48439,Tarrant,13089,DeKalb,GA,Atlanta,130,4323000,33253.846153846156,81,2781000,34333.333333333336,49,1542000
2016,county,48113,Dallas,13089,DeKalb,GA,Atlanta,275,10499000,38178.181818181816,203,6973000,34349.75369458128,72,3526000
2016,county,48085,Collin,13089,DeKalb,GA,Atlanta,94,4315000,45904.255319148935,61,3343000,54803.27868852459,33,972000
2016,county,48439,Tarrant,48121,Denton,TX,Dallas-Fort Worth,6944,226772000,32657.25806451613,8162,309664000,37939.720656701786,-1218,-82892000
2016,county,48113,Dallas,48121,Denton,TX,Dallas-Fort Worth,11519,380855000,33063.19993054953,16347,598499000,36612.16125282927,-4828,-217644000
2016,county,48085,Collin,48121,Denton,TX,Dallas-Fort Worth,9732,390844000,40160.706946157006,12431,546787000,43985.761402944256,-2699,-155943000
2016,county,48439,Tarrant,08031,Denver,CO,Denver,147,4935000,33571.42857142857,203,11011000,54241.379310344826,-56,-6076000
2016,county,48113,Dallas,08031,Denver,CO,Denver,256,13061000,51019.53125,351,22431000,63905.982905982906,-95,-9370000
2016,county,48121,Denton,08031,Denver,CO,Denver,67,3186000,47552.23880597015,91,4701000,51659.34065934066,-24,-1515000
2016,county,48085,Collin,08031,Denver,CO,Denver,69,3426000,49652.17391304348,87,5199000,59758.620689655174,-18,-1773000
2016,county,48439,Tarrant,11001,District of Columbia,DC,D.C.,77,2284000,29662.33766233766,47,2284000,48595.744680851065,30,0
2016,county,48113,Dallas,11001,District of Columbia,DC,D.C.,143,9068000,63412.58741258741,151,9883000,65450.33112582781,-8,-815000
2016,county,48085,Collin,11001,District of Columbia,DC,D.C.,46,2302000,50043.47826086957,27,1576000,58370.37037037037,19,726000
2016,county,48439,Tarrant,35013,Dona Ana,NM,Rural New Mexico,72,1254000,17416.666666666668,53,1397000,26358.490566037737,19,-143000
2016,county,48439,Tarrant,31055,Douglas,NE,Omaha,140,4763000,34021.42857142857,156,3747000,24019.23076923077,-16,1016000
2016,county,48439,Tarrant,08035,Douglas,CO,Denver,117,6879000,58794.8717948718,82,4784000,58341.46341463415,35,2095000
2016,county,48113,Dallas,31055,Douglas,NE,Omaha,182,5059000,27796.703296703297,115,4422000,38452.17391304348,67,637000
2016,county,48113,Dallas,08035,Douglas,CO,Denver,91,4061000,44626.37362637363,102,4702000,46098.03921568627,-11,-641000
2016,county,48121,Denton,08035,Douglas,CO,Denver,103,5108000,49592.23300970874,92,3669000,39880.434782608696,11,1439000
2016,county,48121,Denton,31055,Douglas,NE,Omaha,88,3996000,45409.09090909091,50,1675000,33500.0,38,2321000
2016,county,48085,Collin,08035,Douglas,CO,Denver,161,9676000,60099.37888198758,120,5971000,49758.333333333336,41,3705000
2016,county,48085,Collin,31055,Douglas,NE,Omaha,80,2541000,31762.5,42,1505000,35833.333333333336,38,1036000
2016,county,48439,Tarrant,17043,DuPage,IL,Chicago,160,5258000,32862.5,83,4021000,48445.78313253012,77,1237000
2016,county,48113,Dallas,17043,DuPage,IL,Chicago,247,11835000,47914.97975708502,139,6256000,45007.19424460432,108,5579000
2016,county,48085,Collin,17043,DuPage,IL,Chicago,266,11858000,44578.94736842105,59,3017000,51135.59322033898,207,8841000
2016,county,48113,Dallas,37063,Durham,NC,Raleigh,82,3528000,43024.39024390244,45,1650000,36666.666666666664,37,1878000
2016,county,48439,Tarrant,12031,Duval,FL,Jacksonville,164,4896000,29853.658536585364,150,4009000,26726.666666666668,14,887000
2016,county,48113,Dallas,12031,Duval,FL,Jacksonville,262,10926000,41702.29007633588,164,6416000,39121.95121951219,98,4510000
2016,county,48121,Denton,12031,Duval,FL,Jacksonville,123,3315000,26951.219512195123,50,1845000,36900.0,73,1470000
2016,county,48085,Collin,12031,Duval,FL,Jacksonville,94,3442000,36617.02127659575,102,4740000,46470.58823529412,-8,-1298000
2016,county,48439,Tarrant,22033,East Baton Rouge Parish,LA,Rural Louisiana,130,2638000,20292.30769230769,64,1436000,22437.5,66,1202000
2016,county,48113,Dallas,22033,East Baton Rouge Parish,LA,Rural Louisiana,246,5927000,24093.49593495935,141,3105000,22021.27659574468,105,2822000
2016,county,48085,Collin,22033,East Baton Rouge Parish,LA,Rural Louisiana,95,4242000,44652.63157894737,38,1141000,30026.315789473683,57,3101000
2016,county,48439,Tarrant,48133,Eastland,TX,Rural Texas,58,1823000,31431.03448275862,64,1919000,29984.375,-6,-96000
2016,county,48439,Tarrant,48135,Ector,TX,Rural Texas,382,8516000,22293.193717277485,127,2870000,22598.425196850392,255,5646000
2016,county,48113,Dallas,48135,Ector,TX,Rural Texas,253,5926000,23422.924901185772,133,3090000,23233.082706766916,120,2836000
2016,county,48121,Denton,48135,Ector,TX,Rural Texas,75,1859000,24786.666666666668,55,1328000,24145.454545454544,20,531000
2016,county,48439,Tarrant,48141,El Paso,TX,El Paso,659,12445000,18884.673748103185,394,6653000,16885.786802030456,265,5792000
2016,county,48439,Tarrant,08041,El Paso,CO,Colorado Springs,247,6796000,27514.17004048583,308,7921000,25717.532467532466,-61,-1125000
2016,county,48113,Dallas,48141,El Paso,TX,El Paso,595,12933000,21736.134453781513,498,10415000,20913.654618473895,97,2518000
2016,county,48113,Dallas,08041,El Paso,CO,Colorado Springs,206,4153000,20160.194174757282,207,5162000,24937.19806763285,-1,-1009000
2016,county,48121,Denton,48141,El Paso,TX,El Paso,196,6720000,34285.71428571428,121,2123000,17545.454545454544,75,4597000
2016,county,48121,Denton,08041,El Paso,CO,Colorado Springs,89,2595000,29157.303370786518,147,3568000,24272.108843537415,-58,-973000
2016,county,48085,Collin,48141,El Paso,TX,El Paso,253,7462000,29494.07114624506,132,2897000,21946.969696969696,121,4565000
2016,county,48085,Collin,08041,El Paso,CO,Colorado Springs,145,4031000,27800.0,163,5262000,32282.208588957055,-18,-1231000
2016,county,48439,Tarrant,48139,Ellis,TX,Dallas-Fort Worth,1127,28895000,25638.864241348714,1798,57861000,32180.75639599555,-671,-28966000
2016,county,48113,Dallas,48139,Ellis,TX,Dallas-Fort Worth,2336,51833000,22188.784246575342,4364,103268000,23663.611365719524,-2028,-51435000
2016,county,48121,Denton,48139,Ellis,TX,Dallas-Fort Worth,240,7288000,30366.666666666668,291,8734000,30013.745704467354,-51,-1446000
2016,county,48085,Collin,48139,Ellis,TX,Dallas-Fort Worth,188,5522000,29372.340425531915,280,10530000,37607.142857142855,-92,-5008000
2016,county,48439,Tarrant,48143,Erath,TX,Rural Texas,197,5052000,25644.670050761422,175,4117000,23525.714285714286,22,935000
2016,county,48113,Dallas,48143,Erath,TX,Rural Texas,53,1257000,23716.98113207547,49,954000,19469.38775510204,4,303000
2016,county,48121,Denton,48143,Erath,TX,Rural Texas,41,850000,20731.70731707317,51,812000,15921.56862745098,-10,38000
2016,county,48113,Dallas,36029,Erie,NY,Buffalo,77,2592000,33662.33766233766,32,588000,18375.0,45,2004000
2016,county,48439,Tarrant,12033,Escambia,FL,FL Panhandle,81,1417000,17493.827160493827,70,1533000,21900.0,11,-116000
2016,county,48113,Dallas,12033,Escambia,FL,FL Panhandle,62,1580000,25483.870967741936,46,1693000,36804.34782608696,16,-113000
2016,county,48113,Dallas,34013,Essex,NJ,New York,104,8430000,81057.69230769231,29,1213000,41827.58620689655,75,7217000
2016,county,48439,Tarrant,51059,Fairfax,VA,D.C.,209,9566000,45770.33492822966,119,4849000,40747.899159663866,90,4717000
2016,county,48113,Dallas,51059,Fairfax,VA,D.C.,291,16013000,55027.49140893471,204,10143000,49720.58823529412,87,5870000
2016,county,48121,Denton,51059,Fairfax,VA,D.C.,126,7429000,58960.31746031746,57,2548000,44701.754385964916,69,4881000
2016,county,48085,Collin,51059,Fairfax,VA,D.C.,199,13352000,67095.47738693467,146,7459000,51089.04109589041,53,5893000
2016,county,48113,Dallas,09001,Fairfield,CT,New York,172,19980000,116162.79069767441,74,6607000,89283.78378378379,98,13373000
2016,county,48113,Dallas,48147,Fannin,TX,Rural Texas,92,1833000,19923.91304347826,126,3529000,28007.93650793651,-34,-1696000
2016,county,48121,Denton,48147,Fannin,TX,Rural Texas,46,1273000,27673.91304347826,69,1889000,27376.8115942029,-23,-616000
2016,county,48085,Collin,48147,Fannin,TX,Rural Texas,195,4895000,25102.5641025641,474,12652000,26691.983122362868,-279,-7757000
2016,county,48113,Dallas,37067,Forsyth,NC,Greensboro,63,2784000,44190.47619047619,63,2312000,36698.4126984127,0,472000
2016,county,48439,Tarrant,48157,Fort Bend,TX,Houston,327,15517000,47452.5993883792,351,12658000,36062.67806267806,-24,2859000
2016,county,48113,Dallas,48157,Fort Bend,TX,Houston,378,18371000,48600.5291005291,491,17225000,35081.46639511202,-113,1146000
2016,county,48121,Denton,48157,Fort Bend,TX,Houston,196,9755000,49770.4081632653,166,7737000,46608.43373493976,30,2018000
2016,county,48085,Collin,48157,Fort Bend,TX,Houston,303,14595000,48168.316831683165,288,9414000,32687.5,15,5181000
2016,county,48439,Tarrant,39049,Franklin,OH,Columbus,151,6570000,43509.93377483444,125,4986000,39888.0,26,1584000
2016,county,48113,Dallas,39049,Franklin,OH,Columbus,253,16621000,65695.65217391304,160,5258000,32862.5,93,11363000
2016,county,48121,Denton,39049,Franklin,OH,Columbus,98,3250000,33163.26530612245,38,1127000,29657.894736842107,60,2123000
2016,county,48085,Collin,39049,Franklin,OH,Columbus,141,5384000,38184.397163120564,72,5262000,73083.33333333333,69,122000
2016,county,48113,Dallas,48161,Freestone,TX,Rural Texas,67,1373000,20492.537313432837,61,1093000,17918.032786885247,6,280000
2016,county,48439,Tarrant,06019,Fresno,CA,Fresno,106,2062000,19452.830188679247,70,1065000,15214.285714285714,36,997000
2016,county,48113,Dallas,06019,Fresno,CA,Fresno,73,1812000,24821.91780821918,65,1202000,18492.30769230769,8,610000
2016,county,48439,Tarrant,13121,Fulton,GA,Atlanta,196,9120000,46530.61224489796,165,8864000,53721.21212121212,31,256000
2016,county,48113,Dallas,13121,Fulton,GA,Atlanta,380,30023000,79007.8947368421,344,20301000,59014.53488372093,36,9722000
2016,county,48121,Denton,13121,Fulton,GA,Atlanta,113,6836000,60495.57522123894,89,5036000,56584.269662921346,24,1800000
2016,county,48085,Collin,13121,Fulton,GA,Atlanta,207,12018000,58057.97101449275,204,8127000,39838.23529411765,3,3891000
2016,county,48439,Tarrant,48167,Galveston,TX,Houston,187,5597000,29930.48128342246,223,5957000,26713.004484304933,-36,-360000
2016,county,48113,Dallas,48167,Galveston,TX,Houston,165,4807000,29133.333333333332,173,5423000,31346.820809248555,-8,-616000
2016,county,48121,Denton,48167,Galveston,TX,Houston,97,3251000,33515.463917525776,126,4871000,38658.730158730155,-29,-1620000
2016,county,48085,Collin,48167,Galveston,TX,Houston,66,2924000,44303.030303030304,101,3837000,37990.09900990099,-35,-913000
2016,county,48439,Tarrant,05051,Garland,AR,Rural Arkansas,47,979000,20829.787234042553,42,1376000,32761.904761904763,5,-397000
2016,county,48113,Dallas,05051,Garland,AR,Rural Arkansas,40,1491000,37275.0,58,1723000,29706.896551724138,-18,-232000
2016,county,48439,Tarrant,48181,Grayson,TX,Rural Texas,204,8312000,40745.098039215685,242,7698000,31809.9173553719,-38,614000
2016,county,48113,Dallas,48181,Grayson,TX,Rural Texas,351,10419000,29683.760683760684,570,18327000,32152.63157894737,-219,-7908000
2016,county,48121,Denton,48181,Grayson,TX,Rural Texas,414,11305000,27306.763285024153,817,20639000,25261.933904528763,-403,-9334000
2016,county,48085,Collin,48181,Grayson,TX,Rural Texas,808,21537000,26654.70297029703,1732,50907000,29392.03233256351,-924,-29370000
2016,county,48439,Tarrant,29077,Greene,MO,Rural Missouri,49,1899000,38755.102040816324,68,1774000,26088.235294117647,-19,125000
2016,county,48113,Dallas,29077,Greene,MO,Rural Missouri,62,2062000,33258.06451612903,39,924000,23692.30769230769,23,1138000
2016,county,48439,Tarrant,45045,Greenville,SC,Greenville,66,2074000,31424.242424242424,50,1773000,35460.0,16,301000
2016,county,48113,Dallas,45045,Greenville,SC,Greenville,55,2793000,50781.818181818184,47,1167000,24829.787234042553,8,1626000
2016,county,48439,Tarrant,48183,Gregg,TX,Rural Texas,288,6358000,22076.38888888889,144,3318000,23041.666666666668,144,3040000
2016,county,48113,Dallas,48183,Gregg,TX,Rural Texas,377,6772000,17962.86472148541,215,4177000,19427.906976744187,162,2595000
2016,county,48121,Denton,48183,Gregg,TX,Rural Texas,140,3789000,27064.285714285714,93,2086000,22430.107526881722,47,1703000
2016,county,48085,Collin,48183,Gregg,TX,Rural Texas,120,3210000,26750.0,62,1992000,32129.032258064515,58,1218000
2016,county,48439,Tarrant,48187,Guadalupe,TX,San Antonio,102,3229000,31656.86274509804,84,2924000,34809.52380952381,18,305000
2016,county,48113,Dallas,48187,Guadalupe,TX,San Antonio,65,2151000,33092.307692307695,65,1443000,22200.0,0,708000
2016,county,48085,Collin,48187,Guadalupe,TX,San Antonio,61,2042000,33475.40983606558,41,1429000,34853.65853658537,20,613000
2016,county,48439,Tarrant,37081,Guilford,NC,Greensboro,53,1698000,32037.735849056604,49,1950000,39795.91836734694,4,-252000
2016,county,48439,Tarrant,13135,Gwinnett,GA,Atlanta,148,3867000,26128.37837837838,134,3405000,25410.44776119403,14,462000
2016,county,48113,Dallas,13135,Gwinnett,GA,Atlanta,265,6670000,25169.811320754718,202,4546000,22504.950495049507,63,2124000
2016,county,48121,Denton,13135,Gwinnett,GA,Atlanta,99,3161000,31929.29292929293,50,1247000,24940.0,49,1914000
2016,county,48085,Collin,13135,Gwinnett,GA,Atlanta,151,4239000,28072.847682119205,69,1625000,23550.72463768116,82,2614000
2016,county,48439,Tarrant,39061,Hamilton,OH,Cincinnati,53,2275000,42924.52830188679,39,1355000,34743.58974358974,14,920000
2016,county,48113,Dallas,39061,Hamilton,OH,Cincinnati,175,7667000,43811.42857142857,100,2787000,27870.0,75,4880000
2016,county,48113,Dallas,18057,Hamilton,IN,Indianapolis,57,4130000,72456.14035087719,50,2759000,55180.0,7,1371000
2016,county,48113,Dallas,47065,Hamilton,TN,Chattanooga,32,988000,30875.0,31,1259000,40612.903225806454,1,-271000
2016,county,48085,Collin,18057,Hamilton,IN,Indianapolis,67,4073000,60791.0447761194,56,5055000,90267.85714285714,11,-982000
2016,county,48439,Tarrant,48201,Harris,TX,Houston,2394,83027000,34681.286549707605,1993,106342000,53357.752132463625,401,-23315000
2016,county,48113,Dallas,48201,Harris,TX,Houston,3564,140408000,39396.18406285073,3247,117381000,36150.60055435787,317,23027000
2016,county,48121,Denton,48201,Harris,TX,Houston,1036,40810000,39391.89189189189,816,30893000,37859.06862745098,220,9917000
2016,county,48085,Collin,48201,Harris,TX,Houston,1277,53172000,41638.21456538763,886,32272000,36424.37923250564,391,20900000
2016,county,48439,Tarrant,48203,Harrison,TX,Rural Texas,75,1148000,15306.666666666666,79,1441000,18240.506329113923,-4,-293000
2016,county,48439,Tarrant,28047,Harrison,MS,Gulfport-Biloxi,39,677000,17358.97435897436,35,695000,19857.14285714286,4,-18000
2016,county,48113,Dallas,48203,Harrison,TX,Rural Texas,195,3578000,18348.71794871795,145,3045000,21000.0,50,533000
2016,county,48113,Dallas,28047,Harrison,MS,Gulfport-Biloxi,56,837000,14946.42857142857,32,801000,25031.25,24,36000
2016,county,48439,Tarrant,09003,Hartford,CT,Hartford,92,3806000,41369.565217391304,40,1871000,46775.0,52,1935000
2016,county,48113,Dallas,09003,Hartford,CT,Hartford,109,5696000,52256.880733944956,85,3090000,36352.94117647059,24,2606000
2016,county,48439,Tarrant,48209,Hays,TX,Austin,159,4518000,28415.094339622643,203,6281000,30940.886699507388,-44,-1763000
2016,county,48113,Dallas,48209,Hays,TX,Austin,128,3377000,26382.8125,186,5103000,27435.483870967742,-58,-1726000
2016,county,48121,Denton,48209,Hays,TX,Austin,65,2471000,38015.38461538462,137,6756000,49313.868613138686,-72,-4285000
2016,county,48085,Collin,48209,Hays,TX,Austin,90,2218000,24644.444444444445,117,5229000,44692.307692307695,-27,-3011000
2016,county,48439,Tarrant,48213,Henderson,TX,Rural Texas,153,3578000,23385.62091503268,221,7570000,34253.39366515837,-68,-3992000
2016,county,48113,Dallas,48213,Henderson,TX,Rural Texas,348,10523000,30238.505747126437,570,16767000,29415.78947368421,-222,-6244000
2016,county,48121,Denton,48213,Henderson,TX,Rural Texas,75,1606000,21413.333333333332,99,3145000,31767.676767676767,-24,-1539000
2016,county,48085,Collin,48213,Henderson,TX,Rural Texas,61,2824000,46295.08196721312,126,6201000,49214.28571428572,-65,-3377000
2016,county,48439,Tarrant,27053,Hennepin,MN,Minneapolis,199,10397000,52246.23115577889,130,5542000,42630.769230769234,69,4855000
2016,county,48113,Dallas,27053,Hennepin,MN,Minneapolis,306,16649000,54408.49673202614,199,10140000,50954.77386934673,107,6509000
2016,county,48121,Denton,27053,Hennepin,MN,Minneapolis,138,6195000,44891.30434782609,48,2010000,41875.0,90,4185000
2016,county,48085,Collin,27053,Hennepin,MN,Minneapolis,256,17625000,68847.65625,67,5114000,76328.35820895522,189,12511000
2016,county,48113,Dallas,51087,Henrico,VA,Richmond,73,3670000,50273.97260273973,37,1405000,37972.97297297297,36,2265000
2016,county,48439,Tarrant,48215,Hidalgo,TX,Rural Texas,265,4475000,16886.79245283019,167,3236000,19377.245508982036,98,1239000
2016,county,48113,Dallas,48215,Hidalgo,TX,Rural Texas,376,6322000,16813.82978723404,316,4752000,15037.974683544304,60,1570000
2016,county,48121,Denton,48215,Hidalgo,TX,Rural Texas,106,2122000,20018.867924528302,71,1681000,23676.056338028167,35,441000
2016,county,48085,Collin,48215,Hidalgo,TX,Rural Texas,91,2135000,23461.53846153846,44,746000,16954.545454545456,47,1389000
2016,county,48439,Tarrant,48217,Hill,TX,Rural Texas,157,3586000,22840.76433121019,169,3683000,21792.899408284025,-12,-97000
2016,county,48113,Dallas,48217,Hill,TX,Rural Texas,81,1286000,15876.543209876543,124,2723000,21959.677419354837,-43,-1437000
2016,county,48439,Tarrant,12057,Hillsborough,FL,Tampa,215,8205000,38162.79069767442,232,9260000,39913.793103448275,-17,-1055000
2016,county,48113,Dallas,12057,Hillsborough,FL,Tampa,340,13355000,39279.41176470588,304,15313000,50371.71052631579,36,-1958000
2016,county,48121,Denton,12057,Hillsborough,FL,Tampa,105,4662000,44400.0,77,2677000,34766.23376623377,28,1985000
2016,county,48085,Collin,12057,Hillsborough,FL,Tampa,162,6805000,42006.17283950617,104,3589000,34509.61538461538,58,3216000
2016,county,48439,Tarrant,28049,Hinds,MS,Jackson,180,2685000,14916.666666666666,55,870000,15818.181818181818,125,1815000
2016,county,48113,Dallas,28049,Hinds,MS,Jackson,253,4475000,17687.747035573124,64,1113000,17390.625,189,3362000
2016,county,48439,Tarrant,15003,Honolulu,HI,Rural Hawaii,296,6819000,23037.162162162163,129,3793000,29403.100775193798,167,3026000
2016,county,48113,Dallas,15003,Honolulu,HI,Rural Hawaii,188,4714000,25074.468085106382,123,3747000,30463.414634146342,65,967000
2016,county,48121,Denton,15003,Honolulu,HI,Rural Hawaii,85,1614000,18988.235294117647,39,836000,21435.897435897437,46,778000
2016,county,48085,Collin,15003,Honolulu,HI,Rural Hawaii,126,3279000,26023.809523809523,71,1703000,23985.915492957745,55,1576000
2016,county,48439,Tarrant,48221,Hood,TX,Rural Texas,648,21280000,32839.50617283951,924,32174000,34820.34632034632,-276,-10894000
2016,county,48113,Dallas,48221,Hood,TX,Rural Texas,93,3471000,37322.58064516129,153,6088000,39790.84967320262,-60,-2617000
2016,county,48121,Denton,48221,Hood,TX,Rural Texas,90,3054000,33933.333333333336,116,4963000,42784.48275862069,-26,-1909000
2016,county,48085,Collin,48221,Hood,TX,Rural Texas,35,1201000,34314.28571428572,84,3191000,37988.09523809524,-49,-1990000
2016,county,48439,Tarrant,48223,Hopkins,TX,Rural Texas,49,1098000,22408.163265306124,53,1418000,26754.716981132075,-4,-320000
2016,county,48113,Dallas,48223,Hopkins,TX,Rural Texas,115,2576000,22400.0,140,2163000,15450.0,-25,413000
2016,county,48085,Collin,48223,Hopkins,TX,Rural Texas,49,1186000,24204.081632653062,74,1588000,21459.45945945946,-25,-402000
2016,county,48439,Tarrant,48227,Howard,TX,Rural Texas,94,1567000,16670.212765957447,58,969000,16706.896551724138,36,598000
2016,county,48113,Dallas,48227,Howard,TX,Rural Texas,48,1125000,23437.5,55,729000,13254.545454545454,-7,396000
2016,county,48113,Dallas,24027,Howard,MD,Baltimore,51,2026000,39725.490196078434,55,2073000,37690.90909090909,-4,-47000
2016,county,48113,Dallas,34017,Hudson,NJ,New York,176,11977000,68051.13636363637,110,6746000,61327.27272727273,66,5231000
2016,county,48085,Collin,34017,Hudson,NJ,New York,102,5890000,57745.098039215685,45,2128000,47288.88888888889,57,3762000
2016,county,48439,Tarrant,48231,Hunt,TX,Dallas-Fort Worth,151,3331000,22059.60264900662,222,4631000,20860.36036036036,-71,-1300000
2016,county,48113,Dallas,48231,Hunt,TX,Dallas-Fort Worth,778,13628000,17516.709511568122,1412,29236000,20705.382436260625,-634,-15608000
2016,county,48121,Denton,48231,Hunt,TX,Dallas-Fort Worth,125,2986000,23888.0,221,5780000,26153.846153846152,-96,-2794000
2016,county,48085,Collin,48231,Hunt,TX,Dallas-Fort Worth,559,12437000,22248.65831842576,898,19870000,22126.94877505568,-339,-7433000
2016,county,48439,Tarrant,48237,Jack,TX,Rural Texas,55,1272000,23127.272727272728,52,1281000,24634.615384615383,3,-9000
2016,county,48439,Tarrant,29095,Jackson,MO,Kansas City,187,5935000,31737.9679144385,160,2902000,18137.5,27,3033000
2016,county,48113,Dallas,29095,Jackson,MO,Kansas City,257,5586000,21735.408560311284,167,5440000,32574.850299401198,90,146000
2016,county,48121,Denton,29095,Jackson,MO,Kansas City,70,1914000,27342.85714285714,59,1822000,30881.35593220339,11,92000
2016,county,48085,Collin,29095,Jackson,MO,Kansas City,69,1640000,23768.115942028984,53,1307000,24660.377358490565,16,333000
2016,county,48439,Tarrant,48245,Jefferson,TX,Rural Texas,137,3940000,28759.12408759124,119,2487000,20899.159663865546,18,1453000
2016,county,48439,Tarrant,01073,Jefferson,AL,Birmingham,114,2828000,24807.01754385965,67,2094000,31253.731343283584,47,734000
2016,county,48439,Tarrant,08059,Jefferson,CO,Denver,110,3269000,29718.18181818182,124,5480000,44193.54838709677,-14,-2211000
2016,county,48439,Tarrant,21111,Jefferson,KY,Louisville,81,2414000,29802.46913580247,49,3222000,65755.10204081633,32,-808000
2016,county,48439,Tarrant,05069,Jefferson,AR,Rural Arkansas,66,1039000,15742.424242424242,71,567000,7985.915492957746,-5,472000
2016,county,48113,Dallas,48245,Jefferson,TX,Rural Texas,166,3316000,19975.90361445783,116,2821000,24318.96551724138,50,495000
2016,county,48113,Dallas,21111,Jefferson,KY,Louisville,128,5103000,39867.1875,72,2858000,39694.444444444445,56,2245000
2016,county,48113,Dallas,01073,Jefferson,AL,Birmingham,121,4213000,34818.181818181816,100,4057000,40570.0,21,156000
2016,county,48113,Dallas,08059,Jefferson,CO,Denver,87,5777000,66402.29885057472,143,10442000,73020.97902097902,-56,-4665000
2016,county,48121,Denton,08059,Jefferson,CO,Denver,44,1608000,36545.454545454544,68,2992000,44000.0,-24,-1384000
2016,county,48121,Denton,48245,Jefferson,TX,Rural Texas,41,2454000,59853.65853658537,44,820000,18636.363636363636,-3,1634000
2016,county,48085,Collin,08059,Jefferson,CO,Denver,77,4288000,55688.31168831169,75,2625000,35000.0,2,1663000
2016,county,48439,Tarrant,22051,Jefferson Parish,LA,New Orleans,125,3588000,28704.0,97,2326000,23979.381443298967,28,1262000
2016,county,48113,Dallas,22051,Jefferson Parish,LA,New Orleans,170,4125000,24264.70588235294,106,2997000,28273.584905660377,64,1128000
2016,county,48439,Tarrant,48251,Johnson,TX,Dallas-Fort Worth,3670,85166000,23205.99455040872,5924,149610000,25254.89534098582,-2254,-64444000
2016,county,48439,Tarrant,20091,Johnson,KS,Kansas City,212,8567000,40410.377358490565,132,5920000,44848.48484848485,80,2647000
2016,county,48113,Dallas,48251,Johnson,TX,Dallas-Fort Worth,361,9735000,26966.759002770083,619,14552000,23508.885298869143,-258,-4817000
2016,county,48113,Dallas,20091,Johnson,KS,Kansas City,202,11729000,58064.35643564357,149,8189000,54959.73154362416,53,3540000
2016,county,48121,Denton,48251,Johnson,TX,Dallas-Fort Worth,152,3844000,25289.473684210527,127,4750000,37401.574803149604,25,-906000
2016,county,48121,Denton,20091,Johnson,KS,Kansas City,137,7649000,55832.11678832117,103,3741000,36320.388349514564,34,3908000
2016,county,48085,Collin,20091,Johnson,KS,Kansas City,198,8503000,42944.444444444445,92,3747000,40728.260869565216,106,4756000
2016,county,48085,Collin,48251,Johnson,TX,Dallas-Fort Worth,66,1997000,30257.575757575756,102,3178000,31156.86274509804,-36,-1181000
2016,county,48439,Tarrant,48257,Kaufman,TX,Dallas-Fort Worth,239,5678000,23757.322175732217,367,9967000,27158.038147138963,-128,-4289000
2016,county,48113,Dallas,48257,Kaufman,TX,Dallas-Fort Worth,2278,47557000,20876.646180860404,4811,108528000,22558.303886925794,-2533,-60971000
2016,county,48121,Denton,48257,Kaufman,TX,Dallas-Fort Worth,203,5311000,26162.56157635468,278,8448000,30388.489208633095,-75,-3137000
2016,county,48085,Collin,48257,Kaufman,TX,Dallas-Fort Worth,324,8987000,27737.654320987655,438,12390000,28287.671232876713,-114,-3403000
2016,county,48113,Dallas,26081,Kent,MI,Rural Michigan,137,2839000,20722.627737226278,50,2999000,59980.0,87,-160000
2016,county,48439,Tarrant,06029,Kern,CA,Rural California,115,2387000,20756.521739130436,86,1836000,21348.837209302324,29,551000
2016,county,48113,Dallas,06029,Kern,CA,Rural California,85,2764000,32517.647058823528,43,1452000,33767.441860465115,42,1312000
2016,county,48439,Tarrant,48265,Kerr,TX,Rural Texas,40,1201000,30025.0,59,1059000,17949.15254237288,-19,142000
2016,county,48439,Tarrant,53033,King,WA,Seattle,267,10270000,38464.41947565543,353,15061000,42665.7223796034,-86,-4791000
2016,county,48113,Dallas,53033,King,WA,Seattle,369,17101000,46344.17344173442,637,60849000,95524.3328100471,-268,-43748000
2016,county,48121,Denton,53033,King,WA,Seattle,183,9549000,52180.32786885246,193,8758000,45378.238341968914,-10,791000
2016,county,48085,Collin,53033,King,WA,Seattle,252,13633000,54099.206349206346,326,20580000,63128.83435582822,-74,-6947000
2016,county,48439,Tarrant,36047,Kings,NY,New York,122,2166000,17754.09836065574,71,1938000,27295.774647887323,51,228000
2016,county,48113,Dallas,36047,Kings,NY,New York,268,11090000,41380.59701492537,144,6813000,47312.5,124,4277000
2016,county,48121,Denton,36047,Kings,NY,New York,97,2501000,25783.505154639177,28,825000,29464.285714285714,69,1676000
2016,county,48085,Collin,36047,Kings,NY,New York,105,2470000,23523.809523809523,46,2288000,49739.13043478261,59,182000
2016,county,48113,Dallas,47093,Knox,TN,Knoxville,56,1955000,34910.71428571428,51,2260000,44313.72549019608,5,-305000
2016,county,48439,Tarrant,22055,Lafayette Parish,LA,Rural Louisiana,94,1845000,19627.659574468085,55,1991000,36200.0,39,-146000
2016,county,48113,Dallas,22055,Lafayette Parish,LA,Rural Louisiana,99,2314000,23373.737373737375,35,991000,28314.285714285714,64,1323000
2016,county,48439,Tarrant,18089,Lake,IN,Rural Indiana,137,2892000,21109.48905109489,32,551000,17218.75,105,2341000
2016,county,48439,Tarrant,17097,Lake,IL,Chicago,130,5173000,39792.307692307695,53,2678000,50528.301886792455,77,2495000
2016,county,48439,Tarrant,12069,Lake,FL,Orlando,34,972000,28588.235294117647,52,1805000,34711.53846153846,-18,-833000
2016,county,48113,Dallas,17097,Lake,IL,Chicago,149,10261000,68865.77181208054,72,4390000,60972.22222222222,77,5871000
2016,county,48113,Dallas,18089,Lake,IN,Rural Indiana,104,1867000,17951.923076923078,37,764000,20648.64864864865,67,1103000
2016,county,48439,Tarrant,48277,Lamar,TX,Rural Texas,56,1352000,24142.85714285714,86,1498000,17418.60465116279,-30,-146000
2016,county,48113,Dallas,48277,Lamar,TX,Rural Texas,169,4310000,25502.958579881655,112,2161000,19294.64285714286,57,2149000
2016,county,48121,Denton,48277,Lamar,TX,Rural Texas,44,1030000,23409.090909090908,62,1425000,22983.870967741936,-18,-395000
2016,county,48085,Collin,48277,Lamar,TX,Rural Texas,81,2210000,27283.95061728395,75,2139000,28520.0,6,71000
2016,county,48439,Tarrant,08069,Larimer,CO,Rural Colorado,77,1923000,24974.025974025975,80,2354000,29425.0,-3,-431000
2016,county,48113,Dallas,08069,Larimer,CO,Rural Colorado,34,1473000,43323.529411764706,50,1851000,37020.0,-16,-378000
2016,county,48085,Collin,08069,Larimer,CO,Rural Colorado,57,2900000,50877.19298245614,44,1737000,39477.27272727273,13,1163000
2016,county,48439,Tarrant,12071,Lee,FL,S.W. Florida,51,1304000,25568.62745098039,88,4899000,55670.454545454544,-37,-3595000
2016,county,48113,Dallas,12071,Lee,FL,S.W. Florida,68,3812000,56058.82352941176,66,3625000,54924.242424242424,2,187000
2016,county,48085,Collin,12071,Lee,FL,S.W. Florida,37,1540000,41621.62162162162,50,2118000,42360.0,-13,-578000
2016,county,48113,Dallas,48293,Limestone,TX,Rural Texas,52,972000,18692.30769230769,55,695000,12636.363636363636,-3,277000
2016,county,48113,Dallas,22061,Lincoln Parish,LA,Rural Louisiana,68,1134000,16676.470588235294,54,717000,13277.777777777777,14,417000
2016,county,48439,Tarrant,06037,Los Angeles,CA,Los Angeles,1246,47936000,38471.910112359554,681,20027000,29408.223201174744,565,27909000
2016,county,48113,Dallas,06037,Los Angeles,CA,Los Angeles,1699,74390000,43784.57916421424,1048,60839000,58052.48091603054,651,13551000
2016,county,48121,Denton,06037,Los Angeles,CA,Los Angeles,677,33111000,48908.41949778434,260,9281000,35696.153846153844,417,23830000
2016,county,48085,Collin,06037,Los Angeles,CA,Los Angeles,1140,76648000,67235.08771929824,392,18214000,46464.28571428572,748,58434000
2016,county,48439,Tarrant,51107,Loudoun,VA,Rural Virginia,90,4915000,54611.11111111111,50,2071000,41420.0,40,2844000
2016,county,48113,Dallas,51107,Loudoun,VA,Rural Virginia,69,2476000,35884.057971014496,64,2428000,37937.5,5,48000
2016,county,48085,Collin,51107,Loudoun,VA,Rural Virginia,100,4936000,49360.0,78,2949000,37807.692307692305,22,1987000
2016,county,48439,Tarrant,48303,Lubbock,TX,Rural Texas,573,17798000,31061.08202443281,441,11018000,24984.126984126986,132,6780000
2016,county,48113,Dallas,48303,Lubbock,TX,Rural Texas,534,14644000,27423.220973782772,359,9927000,27651.810584958217,175,4717000
2016,county,48121,Denton,48303,Lubbock,TX,Rural Texas,238,7575000,31827.731092436974,154,3737000,24266.233766233767,84,3838000
2016,county,48085,Collin,48303,Lubbock,TX,Rural Texas,271,8604000,31749.077490774907,155,4128000,26632.25806451613,116,4476000
2016,county,48439,Tarrant,26099,Macomb,MI,Rural Michigan,75,2688000,35840.0,47,1580000,33617.02127659575,28,1108000
2016,county,48439,Tarrant,01089,Madison,AL,Huntsville,75,2668000,35573.333333333336,68,2777000,40838.23529411765,7,-109000
2016,county,48113,Dallas,01089,Madison,AL,Huntsville,49,1923000,39244.897959183676,43,2311000,53744.186046511626,6,-388000
2016,county,48439,Tarrant,12081,Manatee,FL,Rural Florida,42,1063000,25309.52380952381,38,1367000,35973.68421052631,4,-304000
2016,county,48439,Tarrant,04013,Maricopa,AZ,Phoenix,859,45241000,52667.05471478463,738,27098000,36718.15718157181,121,18143000
2016,county,48113,Dallas,04013,Maricopa,AZ,Phoenix,903,49912000,55273.532668881504,732,30893000,42203.551912568306,171,19019000
2016,county,48121,Denton,04013,Maricopa,AZ,Phoenix,483,20001000,41409.93788819876,358,14645000,40907.82122905028,125,5356000
2016,county,48085,Collin,04013,Maricopa,AZ,Phoenix,538,21092000,39204.46096654275,482,22764000,47228.21576763486,56,-1672000
2016,county,48439,Tarrant,18097,Marion,IN,Indianapolis,183,4108000,22448.087431693988,115,1508000,13113.04347826087,68,2600000
2016,county,48113,Dallas,18097,Marion,IN,Indianapolis,249,6293000,25273.092369477912,141,5250000,37234.04255319149,108,1043000
2016,county,48121,Denton,18097,Marion,IN,Indianapolis,68,1904000,28000.0,57,881000,15456.140350877193,11,1023000
2016,county,48113,Dallas,17113,McLean,IL,Rural Illinois,136,7249000,53301.470588235294,30,1092000,36400.0,106,6157000
2016,county,48439,Tarrant,48309,McLennan,TX,Rural Texas,539,13881000,25753.246753246753,479,10929000,22816.283924843425,60,2952000
2016,county,48113,Dallas,48309,McLennan,TX,Rural Texas,507,13316000,26264.299802761343,473,11070000,23403.805496828754,34,2246000
2016,county,48121,Denton,48309,McLennan,TX,Rural Texas,190,3880000,20421.052631578947,95,2805000,29526.315789473683,95,1075000
2016,county,48085,Collin,48309,McLennan,TX,Rural Texas,134,4885000,36455.22388059701,155,5628000,36309.67741935484,-21,-743000
2016,county,48439,Tarrant,37119,Mecklenburg,NC,Charlotte,158,6103000,38626.582278481015,146,6552000,44876.71232876712,12,-449000
2016,county,48113,Dallas,37119,Mecklenburg,NC,Charlotte,314,21108000,67222.92993630574,215,11274000,52437.20930232558,99,9834000
2016,county,48121,Denton,37119,Mecklenburg,NC,Charlotte,81,2689000,33197.53086419753,70,3976000,56800.0,11,-1287000
2016,county,48085,Collin,37119,Mecklenburg,NC,Charlotte,185,8292000,44821.62162162162,95,4706000,49536.84210526316,90,3586000
2016,county,48439,Tarrant,12086,Miami-Dade,FL,Miami,313,7249000,23159.744408945688,175,6047000,34554.28571428572,138,1202000
2016,county,48113,Dallas,12086,Miami-Dade,FL,Miami,435,21422000,49245.97701149425,293,14959000,51054.60750853243,142,6463000
2016,county,48121,Denton,12086,Miami-Dade,FL,Miami,136,3096000,22764.70588235294,50,1286000,25720.0,86,1810000
2016,county,48085,Collin,12086,Miami-Dade,FL,Miami,136,3474000,25544.117647058825,60,2768000,46133.333333333336,76,706000
2016,county,48439,Tarrant,25017,Middlesex,MA,Boston,130,6044000,46492.307692307695,93,6038000,64924.7311827957,37,6000
2016,county,48439,Tarrant,34023,Middlesex,NJ,New York,103,4032000,39145.63106796116,50,1753000,35060.0,53,2279000
2016,county,48113,Dallas,25017,Middlesex,MA,Boston,274,10731000,39164.233576642335,130,8093000,62253.846153846156,144,2638000
2016,county,48113,Dallas,34023,Middlesex,NJ,New York,245,10093000,41195.91836734694,94,3385000,36010.63829787234,151,6708000
2016,county,48121,Denton,25017,Middlesex,MA,Boston,77,3215000,41753.246753246756,50,2211000,44220.0,27,1004000
2016,county,48085,Collin,34023,Middlesex,NJ,New York,402,15569000,38728.85572139303,79,2587000,32746.835443037973,323,12982000
2016,county,48085,Collin,25017,Middlesex,MA,Boston,205,9030000,44048.78048780488,93,5645000,60698.92473118279,112,3385000
2016,county,48439,Tarrant,48329,Midland,TX,Rural Texas,522,16943000,32457.854406130267,351,11509000,32789.17378917379,171,5434000
2016,county,48113,Dallas,48329,Midland,TX,Rural Texas,354,13396000,37841.80790960452,267,13119000,49134.831460674155,87,277000
2016,county,48121,Denton,48329,Midland,TX,Rural Texas,186,7000000,37634.408602150535,111,2898000,26108.108108108107,75,4102000
2016,county,48085,Collin,48329,Midland,TX,Rural Texas,166,6837000,41186.74698795181,56,1910000,34107.142857142855,110,4927000
2016,county,48113,Dallas,05091,Miller,AR,Rural Arkansas,73,1061000,14534.246575342466,52,861000,16557.69230769231,21,200000
2016,county,48439,Tarrant,55079,Milwaukee,WI,Milwaukee,272,5871000,21584.558823529413,87,1960000,22528.735632183907,185,3911000
2016,county,48113,Dallas,55079,Milwaukee,WI,Milwaukee,313,7242000,23137.38019169329,77,1592000,20675.324675324675,236,5650000
2016,county,48113,Dallas,01097,Mobile,AL,Mobile,62,1261000,20338.709677419356,40,719000,17975.0,22,542000
2016,county,48439,Tarrant,36055,Monroe,NY,Rochester,76,1442000,18973.684210526317,39,1124000,28820.51282051282,37,318000
2016,county,48113,Dallas,36055,Monroe,NY,Rochester,75,2622000,34960.0,43,1055000,24534.883720930233,32,1567000
2016,county,48439,Tarrant,48337,Montague,TX,Rural Texas,60,1370000,22833.333333333332,117,3065000,26196.581196581195,-57,-1695000
2016,county,48121,Denton,48337,Montague,TX,Rural Texas,80,1713000,21412.5,99,2672000,26989.89898989899,-19,-959000
2016,county,48113,Dallas,06053,Monterey,CA,Rural California,54,890000,16481.48148148148,40,1813000,45325.0,14,-923000
2016,county,48439,Tarrant,48339,Montgomery,TX,Houston,341,13322000,39067.4486803519,389,15300000,39331.619537275066,-48,-1978000
2016,county,48439,Tarrant,24031,Montgomery,MD,D.C.,110,3649000,33172.72727272727,75,7721000,102946.66666666667,35,-4072000
2016,county,48439,Tarrant,39113,Montgomery,OH,Rural Ohio,77,3184000,41350.64935064935,55,1275000,23181.81818181818,22,1909000
2016,county,48113,Dallas,48339,Montgomery,TX,Houston,270,12331000,45670.37037037037,276,11347000,41112.31884057971,-6,984000
2016,county,48113,Dallas,24031,Montgomery,MD,D.C.,204,14561000,71377.45098039215,146,7727000,52924.65753424657,58,6834000
2016,county,48113,Dallas,42091,Montgomery,PA,Philadelphia,76,3525000,46381.57894736842,58,2172000,37448.275862068964,18,1353000
2016,county,48121,Denton,48339,Montgomery,TX,Houston,181,7677000,42414.36464088398,249,9545000,38333.333333333336,-68,-1868000
2016,county,48085,Collin,48339,Montgomery,TX,Houston,207,8136000,39304.34782608696,210,10489000,49947.619047619046,-3,-2353000
2016,county,48085,Collin,24031,Montgomery,MD,D.C.,126,5860000,46507.93650793651,42,1976000,47047.619047619046,84,3884000
2016,county,48113,Dallas,34027,Morris,NJ,New York,87,7051000,81045.97701149425,52,2745000,52788.46153846154,35,4306000
2016,county,48439,Tarrant,41051,Multnomah,OR,Portland,102,2433000,23852.941176470587,78,2570000,32948.717948717946,24,-137000
2016,county,48113,Dallas,41051,Multnomah,OR,Portland,77,2967000,38532.46753246753,164,6924000,42219.51219512195,-87,-3957000
2016,county,48439,Tarrant,48347,Nacogdoches,TX,Rural Texas,72,1712000,23777.777777777777,66,1470000,22272.727272727272,6,242000
2016,county,48113,Dallas,48347,Nacogdoches,TX,Rural Texas,119,2075000,17436.974789915967,126,1545000,12261.904761904761,-7,530000
2016,county,48113,Dallas,36059,Nassau,NY,New York,187,6514000,34834.22459893048,40,1180000,29500.0,147,5334000
2016,county,48439,Tarrant,48349,Navarro,TX,Rural Texas,182,2831000,15554.945054945056,163,4078000,25018.40490797546,19,-1247000
2016,county,48113,Dallas,48349,Navarro,TX,Rural Texas,336,5103000,15187.5,402,6988000,17383.084577114427,-66,-1885000
2016,county,48121,Denton,48349,Navarro,TX,Rural Texas,46,1072000,23304.347826086956,60,2149000,35816.666666666664,-14,-1077000
2016,county,48085,Collin,48349,Navarro,TX,Rural Texas,44,1121000,25477.272727272728,41,2943000,71780.48780487805,3,-1822000
2016,county,48113,Dallas,10003,New Castle,DE,Rural Delaware,71,2904000,40901.40845070423,46,2461000,53500.0,25,443000
2016,county,48113,Dallas,09009,New Haven,CT,New Haven,59,3025000,51271.186440677964,41,1527000,37243.90243902439,18,1498000
2016,county,48439,Tarrant,36061,New York,NY,New York,122,7853000,64368.852459016394,96,5980000,62291.666666666664,26,1873000
2016,county,48113,Dallas,36061,New York,NY,New York,455,48956000,107595.6043956044,359,37969000,105763.23119777159,96,10987000
2016,county,48121,Denton,36061,New York,NY,New York,62,3646000,58806.45161290323,46,3967000,86239.13043478261,16,-321000
2016,county,48085,Collin,36061,New York,NY,New York,120,8720000,72666.66666666667,100,7147000,71470.0,20,1573000
2016,county,48439,Tarrant,51700,Newport News city,VA,Hampton Roads,54,683000,12648.148148148148,53,1017000,19188.67924528302,1,-334000
2016,county,48113,Dallas,25021,Norfolk,MA,Boston,78,4226000,54179.48717948718,64,3199000,49984.375,14,1027000
2016,county,48439,Tarrant,51710,Norfolk city,VA,Hampton Roads,75,1479000,19720.0,41,800000,19512.19512195122,34,679000
2016,county,48113,Dallas,51710,Norfolk city,VA,Hampton Roads,59,1155000,19576.271186440677,31,701000,22612.90322580645,28,454000
2016,county,48439,Tarrant,48355,Nueces,TX,Rural Texas,245,6498000,26522.448979591838,250,5650000,22600.0,-5,848000
2016,county,48113,Dallas,48355,Nueces,TX,Rural Texas,253,9047000,35758.89328063241,179,6442000,35988.82681564246,74,2605000
2016,county,48121,Denton,48355,Nueces,TX,Rural Texas,104,3122000,30019.23076923077,60,1589000,26483.333333333332,44,1533000
2016,county,48085,Collin,48355,Nueces,TX,Rural Texas,123,4908000,39902.439024390245,85,2547000,29964.70588235294,38,2361000
2016,county,48439,Tarrant,26125,Oakland,MI,Detroit,139,5131000,36913.6690647482,93,5274000,56709.67741935484,46,-143000
2016,county,48113,Dallas,26125,Oakland,MI,Detroit,230,16241000,70613.04347826086,114,5159000,45254.38596491228,116,11082000
2016,county,48121,Denton,26125,Oakland,MI,Detroit,109,6073000,55715.59633027523,61,2063000,33819.67213114754,48,4010000
2016,county,48085,Collin,26125,Oakland,MI,Detroit,190,8176000,43031.57894736842,65,3187000,49030.769230769234,125,4989000
2016,county,48439,Tarrant,12091,Okaloosa,FL,FL Panhandle,92,3045000,33097.82608695652,47,1456000,30978.72340425532,45,1589000
2016,county,48113,Dallas,12091,Okaloosa,FL,FL Panhandle,37,899000,24297.297297297297,35,1110000,31714.285714285714,2,-211000
2016,county,48439,Tarrant,40109,Oklahoma,OK,Oklahoma City,572,16259000,28424.825174825175,443,12883000,29081.264108352145,129,3376000
2016,county,48113,Dallas,40109,Oklahoma,OK,Oklahoma City,667,24339000,36490.25487256372,478,18050000,37761.50627615063,189,6289000
2016,county,48121,Denton,40109,Oklahoma,OK,Oklahoma City,262,13511000,51568.70229007633,229,7411000,32362.445414847163,33,6100000
2016,county,48085,Collin,40109,Oklahoma,OK,Oklahoma City,280,10180000,36357.142857142855,238,12400000,52100.84033613445,42,-2220000
2016,county,48439,Tarrant,37133,Onslow,NC,Rural North Carolina,138,2268000,16434.782608695652,78,1440000,18461.53846153846,60,828000
2016,county,48439,Tarrant,06059,Orange,CA,Los Angeles,533,23726000,44514.0712945591,315,15197000,48244.444444444445,218,8529000
2016,county,48439,Tarrant,12095,Orange,FL,Orlando,207,8227000,39743.961352657,173,5942000,34346.82080924856,34,2285000
2016,county,48439,Tarrant,36071,Orange,NY,Rural New York,60,967000,16116.666666666666,48,950000,19791.666666666668,12,17000
2016,county,48113,Dallas,06059,Orange,CA,Los Angeles,593,48063000,81050.59021922428,439,29495000,67186.7881548975,154,18568000
2016,county,48113,Dallas,12095,Orange,FL,Orlando,265,9410000,35509.43396226415,216,8695000,40254.62962962963,49,715000
2016,county,48121,Denton,06059,Orange,CA,Los Angeles,470,23120000,49191.48936170213,170,8264000,48611.76470588235,300,14856000
2016,county,48121,Denton,12095,Orange,FL,Orlando,108,3167000,29324.074074074073,85,2310000,27176.470588235294,23,857000
2016,county,48085,Collin,06059,Orange,CA,Los Angeles,672,30944000,46047.619047619046,244,10809000,44299.18032786885,428,20135000
2016,county,48085,Collin,12095,Orange,FL,Orlando,140,4466000,31900.0,139,5219000,37546.76258992806,1,-753000
2016,county,48439,Tarrant,22071,Orleans Parish,LA,New Orleans,140,2656000,18971.428571428572,77,2068000,26857.14285714286,63,588000
2016,county,48113,Dallas,22071,Orleans Parish,LA,New Orleans,218,6622000,30376.146788990827,223,6342000,28439.461883408072,-5,280000
2016,county,48085,Collin,22071,Orleans Parish,LA,New Orleans,63,1153000,18301.5873015873,48,1932000,40250.0,15,-779000
2016,county,48439,Tarrant,12097,Osceola,FL,Orlando,71,1255000,17676.056338028167,40,1070000,26750.0,31,185000
2016,county,48113,Dallas,12097,Osceola,FL,Orlando,48,846000,17625.0,44,1720000,39090.90909090909,4,-874000
2016,county,48439,Tarrant,22073,Ouachita Parish,LA,Rural Louisiana,181,2430000,13425.414364640885,69,544000,7884.057971014493,112,1886000
2016,county,48113,Dallas,22073,Ouachita Parish,LA,Rural Louisiana,349,5436000,15575.93123209169,98,1389000,14173.469387755102,251,4047000
2016,county,48439,Tarrant,12099,Palm Beach,FL,Miami,114,3522000,30894.736842105263,126,4449000,35309.52380952381,-12,-927000
2016,county,48113,Dallas,12099,Palm Beach,FL,Miami,202,9653000,47787.12871287129,199,5220000,26231.155778894474,3,4433000
2016,county,48121,Denton,12099,Palm Beach,FL,Miami,100,3417000,34170.0,80,5665000,70812.5,20,-2248000
2016,county,48085,Collin,12099,Palm Beach,FL,Miami,113,3720000,32920.35398230088,121,6212000,51338.842975206615,-8,-2492000
2016,county,48439,Tarrant,48363,Palo Pinto,TX,Rural Texas,167,4267000,25550.898203592813,250,7239000,28956.0,-83,-2972000
2016,county,48439,Tarrant,48367,Parker,TX,Dallas-Fort Worth,2696,92466000,34297.47774480712,4736,231638000,48910.05067567567,-2040,-139172000
2016,county,48113,Dallas,48367,Parker,TX,Dallas-Fort Worth,157,4930000,31401.273885350318,265,11078000,41803.77358490566,-108,-6148000
2016,county,48121,Denton,48367,Parker,TX,Dallas-Fort Worth,159,5152000,32402.51572327044,245,8800000,35918.36734693877,-86,-3648000
2016,county,48085,Collin,48367,Parker,TX,Dallas-Fort Worth,70,2692000,38457.142857142855,129,4016000,31131.782945736435,-59,-1324000
2016,county,48439,Tarrant,12101,Pasco,FL,Tampa,61,1792000,29377.049180327867,47,1212000,25787.23404255319,14,580000
2016,county,48439,Tarrant,42101,Philadelphia,PA,Philadelphia,107,1622000,15158.878504672897,46,1970000,42826.086956521736,61,-348000
2016,county,48113,Dallas,42101,Philadelphia,PA,Philadelphia,173,10606000,61306.35838150289,114,6055000,53114.0350877193,59,4551000
2016,county,48439,Tarrant,53053,Pierce,WA,Seattle,158,2970000,18797.46835443038,149,3228000,21664.42953020134,9,-258000
2016,county,48113,Dallas,53053,Pierce,WA,Seattle,171,3732000,21824.56140350877,117,6399000,54692.307692307695,54,-2667000
2016,county,48121,Denton,53053,Pierce,WA,Seattle,99,4733000,47808.080808080806,82,2742000,33439.0243902439,17,1991000
2016,county,48085,Collin,53053,Pierce,WA,Seattle,77,2263000,29389.61038961039,59,3036000,51457.627118644064,18,-773000
2016,county,48439,Tarrant,04019,Pima,AZ,Tucson,170,4391000,25829.41176470588,141,4428000,31404.255319148935,29,-37000
2016,county,48113,Dallas,04019,Pima,AZ,Tucson,164,7080000,43170.73170731707,128,6260000,48906.25,36,820000
2016,county,48121,Denton,04019,Pima,AZ,Tucson,62,1556000,25096.774193548386,69,3094000,44840.57971014493,-7,-1538000
2016,county,48085,Collin,04019,Pima,AZ,Tucson,114,5217000,45763.15789473684,103,5225000,50728.155339805824,11,-8000
2016,county,48439,Tarrant,04021,Pinal,AZ,Phoenix,67,1258000,18776.119402985074,50,718000,14360.0,17,540000
2016,county,48439,Tarrant,12103,Pinellas,FL,Tampa,115,4589000,39904.34782608696,119,4575000,38445.378151260506,-4,14000
2016,county,48113,Dallas,12103,Pinellas,FL,Tampa,116,4603000,39681.03448275862,146,6829000,46773.97260273973,-30,-2226000
2016,county,48121,Denton,12103,Pinellas,FL,Tampa,51,2120000,41568.62745098039,85,3023000,35564.705882352944,-34,-903000
2016,county,48085,Collin,12103,Pinellas,FL,Tampa,62,3769000,60790.32258064516,86,3908000,45441.86046511628,-24,-139000
2016,county,48439,Tarrant,12105,Polk,FL,Orlando,76,1983000,26092.105263157893,53,1576000,29735.849056603773,23,407000
2016,county,48439,Tarrant,19153,Polk,IA,Rural Iowa,62,1507000,24306.451612903227,49,1153000,23530.61224489796,13,354000
2016,county,48113,Dallas,19153,Polk,IA,Rural Iowa,51,1653000,32411.764705882353,86,1861000,21639.53488372093,-35,-208000
2016,county,48113,Dallas,12105,Polk,FL,Orlando,51,1004000,19686.274509803923,79,1278000,16177.215189873417,-28,-274000
2016,county,48439,Tarrant,48375,Potter,TX,Rural Texas,151,3997000,26470.19867549669,115,2049000,17817.391304347828,36,1948000
2016,county,48113,Dallas,48375,Potter,TX,Rural Texas,165,2745000,16636.363636363636,96,1633000,17010.416666666668,69,1112000
2016,county,48439,Tarrant,24033,Prince George,MD,Rural Maryland,124,3311000,26701.612903225807,39,1513000,38794.8717948718,85,1798000
2016,county,48113,Dallas,24033,Prince George,MD,Rural Maryland,167,3827000,22916.16766467066,68,1723000,25338.235294117647,99,2104000
2016,county,48439,Tarrant,51153,Prince William,VA,Rural Virginia,132,3699000,28022.727272727272,61,1506000,24688.524590163935,71,2193000
2016,county,48113,Dallas,51153,Prince William,VA,Rural Virginia,77,2865000,37207.792207792205,45,1201000,26688.88888888889,32,1664000
2016,county,48113,Dallas,44007,Providence,RI,Providence,69,2302000,33362.31884057971,55,2042000,37127.27272727273,14,260000
2016,county,48439,Tarrant,05119,Pulaski,AR,Little Rock,259,5385000,20791.50579150579,155,3768000,24309.677419354837,104,1617000
2016,county,48113,Dallas,05119,Pulaski,AR,Little Rock,445,20983000,47152.808988764045,242,5203000,21500.0,203,15780000
2016,county,48121,Denton,05119,Pulaski,AR,Little Rock,104,3883000,37336.53846153846,83,2502000,30144.578313253012,21,1381000
2016,county,48085,Collin,05119,Pulaski,AR,Little Rock,194,5543000,28572.164948453606,67,2504000,37373.13432835821,127,3039000
2016,county,48439,Tarrant,36081,Queens,NY,New York,250,4062000,16248.0,92,2335000,25380.434782608696,158,1727000
2016,county,48113,Dallas,36081,Queens,NY,New York,290,9854000,33979.31034482759,83,3639000,43843.3734939759,207,6215000
2016,county,48085,Collin,36081,Queens,NY,New York,194,5068000,26123.711340206184,48,1622000,33791.666666666664,146,3446000
2016,county,48113,Dallas,48379,Rains,TX,Rural Texas,39,1288000,33025.64102564102,87,3030000,34827.58620689655,-48,-1742000
2016,county,48439,Tarrant,27123,Ramsey,MN,Minneapolis,40,1824000,45600.0,78,2159000,27679.48717948718,-38,-335000
2016,county,48113,Dallas,27123,Ramsey,MN,Minneapolis,66,2760000,41818.181818181816,71,1056000,14873.239436619719,-5,1704000
2016,county,48439,Tarrant,48381,Randall,TX,Rural Texas,253,7406000,29272.727272727272,150,4153000,27686.666666666668,103,3253000
2016,county,48113,Dallas,48381,Randall,TX,Rural Texas,153,4252000,27790.849673202614,101,3404000,33702.9702970297,52,848000
2016,county,48121,Denton,48381,Randall,TX,Rural Texas,92,2925000,31793.478260869564,104,3073000,29548.076923076922,-12,-148000
2016,county,48085,Collin,48381,Randall,TX,Rural Texas,100,4438000,44380.0,53,1815000,34245.28301886792,47,2623000
2016,county,48439,Tarrant,22079,Rapides Parish,LA,Rural Louisiana,83,2060000,24819.277108433736,40,670000,16750.0,43,1390000
2016,county,48113,Dallas,22079,Rapides Parish,LA,Rural Louisiana,87,1701000,19551.724137931036,33,684000,20727.272727272728,54,1017000
2016,county,48439,Tarrant,45079,Richland,SC,Columbia,41,2405000,58658.53658536585,49,1263000,25775.51020408163,-8,1142000
2016,county,48439,Tarrant,06065,Riverside,CA,San Bernardino-Riverside,409,10885000,26613.691931540343,207,7343000,35473.42995169082,202,3542000
2016,county,48113,Dallas,06065,Riverside,CA,San Bernardino-Riverside,290,8026000,27675.862068965518,199,4940000,24824.120603015075,91,3086000
2016,county,48121,Denton,06065,Riverside,CA,San Bernardino-Riverside,176,5456000,31000.0,86,2725000,31686.04651162791,90,2731000
2016,county,48085,Collin,06065,Riverside,CA,San Bernardino-Riverside,283,9869000,34872.79151943463,157,3723000,23713.375796178345,126,6146000
2016,county,48439,Tarrant,48397,Rockwall,TX,Dallas-Fort Worth,185,6311000,34113.51351351351,285,11516000,40407.01754385965,-100,-5205000
2016,county,48113,Dallas,48397,Rockwall,TX,Dallas-Fort Worth,1720,54425000,31642.441860465115,3262,107162000,32851.6247700797,-1542,-52737000
2016,county,48121,Denton,48397,Rockwall,TX,Dallas-Fort Worth,210,8222000,39152.380952380954,271,10246000,37808.118081180815,-61,-2024000
2016,county,48085,Collin,48397,Rockwall,TX,Dallas-Fort Worth,912,27943000,30639.254385964912,1066,45076000,42285.17823639775,-154,-17133000
2016,county,48439,Tarrant,48401,Rusk,TX,Rural Texas,42,834000,19857.14285714286,46,771000,16760.869565217392,-4,63000
2016,county,48113,Dallas,48401,Rusk,TX,Rural Texas,69,1407000,20391.304347826088,79,1094000,13848.101265822785,-10,313000
2016,county,48439,Tarrant,47149,Rutherford,TN,Nashville,46,961000,20891.304347826088,67,1807000,26970.149253731342,-21,-846000
2016,county,48439,Tarrant,06067,Sacramento,CA,Sacramento,151,4317000,28589.403973509932,101,1870000,18514.851485148516,50,2447000
2016,county,48113,Dallas,06067,Sacramento,CA,Sacramento,140,4756000,33971.42857142857,142,4344000,30591.549295774646,-2,412000
2016,county,48085,Collin,06067,Sacramento,CA,Sacramento,114,2971000,26061.40350877193,56,1362000,24321.428571428572,58,1609000
2016,county,48439,Tarrant,49035,Salt Lake,UT,Salt Lake,125,3945000,31560.0,139,2894000,20820.143884892088,-14,1051000
2016,county,48113,Dallas,49035,Salt Lake,UT,Salt Lake,188,11355000,60398.936170212764,164,7433000,45323.170731707316,24,3922000
2016,county,48121,Denton,49035,Salt Lake,UT,Salt Lake,113,3668000,32460.17699115044,95,2349000,24726.315789473683,18,1319000
2016,county,48085,Collin,49035,Salt Lake,UT,Salt Lake,131,4090000,31221.374045801527,62,2050000,33064.51612903226,69,2040000
2016,county,48439,Tarrant,06071,San Bernardino,CA,San Bernardino-Riverside,379,8289000,21870.71240105541,189,4111000,21751.32275132275,190,4178000
2016,county,48113,Dallas,06071,San Bernardino,CA,San Bernardino-Riverside,276,5786000,20963.768115942028,182,3173000,17434.065934065933,94,2613000
2016,county,48121,Denton,06071,San Bernardino,CA,San Bernardino-Riverside,181,4511000,24922.651933701658,70,1548000,22114.285714285714,111,2963000
2016,county,48085,Collin,06071,San Bernardino,CA,San Bernardino-Riverside,165,4587000,27800.0,63,1194000,18952.380952380954,102,3393000
2016,county,48439,Tarrant,06073,San Diego,CA,San Diego,821,19848000,24175.395858708893,483,15957000,33037.26708074534,338,3891000
2016,county,48113,Dallas,06073,San Diego,CA,San Diego,733,22600000,30832.196452933153,492,20172000,41000.0,241,2428000
2016,county,48121,Denton,06073,San Diego,CA,San Diego,336,16753000,49860.119047619046,175,8640000,49371.42857142857,161,8113000
2016,county,48085,Collin,06073,San Diego,CA,San Diego,529,19181000,36258.97920604915,223,8294000,37192.825112107625,306,10887000
2016,county,48439,Tarrant,06075,San Francisco,CA,Bay Area,48,3495000,72812.5,58,3463000,59706.89655172414,-10,32000
2016,county,48113,Dallas,06075,San Francisco,CA,Bay Area,133,18065000,135827.06766917295,203,19157000,94369.45812807881,-70,-1092000
2016,county,48085,Collin,06075,San Francisco,CA,Bay Area,41,2942000,71756.09756097561,53,4120000,77735.84905660378,-12,-1178000
2016,county,48439,Tarrant,06077,San Joaquin,CA,Bay Area,61,2893000,47426.229508196724,44,1196000,27181.81818181818,17,1697000
2016,county,48113,Dallas,06077,San Joaquin,CA,Bay Area,51,1213000,23784.313725490196,49,896000,18285.714285714286,2,317000
2016,county,48439,Tarrant,06081,San Mateo,CA,Bay Area,80,3286000,41075.0,58,3786000,65275.862068965514,22,-500000
2016,county,48113,Dallas,06081,San Mateo,CA,Bay Area,100,6638000,66380.0,99,6288000,63515.15151515151,1,350000
2016,county,48085,Collin,06081,San Mateo,CA,Bay Area,85,3388000,39858.82352941176,67,3322000,49582.08955223881,18,66000
2016,county,48439,Tarrant,48409,San Patricio,TX,Rural Texas,34,785000,23088.235294117647,38,811000,21342.105263157893,-4,-26000
2016,county,48439,Tarrant,35043,Sandoval,NM,Albuquerque,53,1311000,24735.849056603773,39,1595000,40897.4358974359,14,-284000
2016,county,48439,Tarrant,06083,Santa Barbara,CA,Rural California,50,1732000,34640.0,38,899000,23657.894736842107,12,833000
2016,county,48439,Tarrant,06085,Santa Clara,CA,Bay Area,213,12686000,59558.68544600939,128,9919000,77492.1875,85,2767000
2016,county,48113,Dallas,06085,Santa Clara,CA,Bay Area,359,18632000,51899.721448467964,299,21112000,70608.69565217392,60,-2480000
2016,county,48121,Denton,06085,Santa Clara,CA,Bay Area,162,9518000,58753.08641975309,89,5277000,59292.13483146067,73,4241000
2016,county,48085,Collin,06085,Santa Clara,CA,Bay Area,433,21986000,50775.98152424942,302,22792000,75470.1986754967,131,-806000
2016,county,48113,Dallas,35049,Santa Fe,NM,Rural New Mexico,38,3637000,95710.52631578948,76,6420000,84473.68421052632,-38,-2783000
2016,county,48439,Tarrant,12113,Santa Rosa,FL,FL Panhandle,60,1623000,27050.0,38,1207000,31763.157894736843,22,416000
2016,county,48439,Tarrant,12115,Sarasota,FL,S.W. Florida,53,1637000,30886.79245283019,58,1409000,24293.103448275862,-5,228000
2016,county,48113,Dallas,12115,Sarasota,FL,S.W. Florida,47,1491000,31723.40425531915,35,4312000,123200.0,12,-2821000
2016,county,48439,Tarrant,05131,Sebastian,AR,Rural Arkansas,44,636000,14454.545454545454,42,754000,17952.380952380954,2,-118000
2016,county,48113,Dallas,05131,Sebastian,AR,Rural Arkansas,50,2404000,48080.0,48,1140000,23750.0,2,1264000
2016,county,48439,Tarrant,20173,Sedgwick,KS,Rural Kansas,312,6859000,21983.97435897436,201,5750000,28606.965174129353,111,1109000
2016,county,48113,Dallas,20173,Sedgwick,KS,Rural Kansas,229,6523000,28484.71615720524,121,2804000,23173.553719008265,108,3719000
2016,county,48121,Denton,20173,Sedgwick,KS,Rural Kansas,121,4175000,34504.13223140496,55,1963000,35690.90909090909,66,2212000
2016,county,48085,Collin,20173,Sedgwick,KS,Rural Kansas,101,3234000,32019.80198019802,48,1496000,31166.666666666668,53,1738000
2016,county,48439,Tarrant,12117,Seminole,FL,Orlando,51,1364000,26745.098039215685,96,3354000,34937.5,-45,-1990000
2016,county,48113,Dallas,12117,Seminole,FL,Orlando,62,2408000,38838.709677419356,62,2314000,37322.58064516129,0,94000
2016,county,48085,Collin,12117,Seminole,FL,Orlando,55,1709000,31072.727272727272,72,2496000,34666.666666666664,-17,-787000
2016,county,48439,Tarrant,47157,Shelby,TN,Memphis,410,8997000,21943.90243902439,179,4809000,26865.921787709496,231,4188000
2016,county,48113,Dallas,47157,Shelby,TN,Memphis,602,21189000,35197.67441860465,240,6097000,25404.166666666668,362,15092000
2016,county,48121,Denton,47157,Shelby,TN,Memphis,226,7695000,34048.67256637168,119,3630000,30504.201680672268,107,4065000
2016,county,48085,Collin,47157,Shelby,TN,Memphis,255,7913000,31031.37254901961,79,2696000,34126.582278481015,176,5217000
2016,county,48439,Tarrant,48423,Smith,TX,Rural Texas,445,12930000,29056.1797752809,418,10874000,26014.354066985645,27,2056000
2016,county,48113,Dallas,48423,Smith,TX,Rural Texas,643,14893000,23161.741835147746,618,15717000,25432.038834951458,25,-824000
2016,county,48121,Denton,48423,Smith,TX,Rural Texas,241,6387000,26502.07468879668,201,5898000,29343.283582089553,40,489000
2016,county,48085,Collin,48423,Smith,TX,Rural Texas,235,6239000,26548.936170212764,229,7945000,34694.323144104805,6,-1706000
2016,county,48439,Tarrant,53061,Snohomish,WA,Seattle,95,3681000,38747.36842105263,102,3857000,37813.72549019608,-7,-176000
2016,county,48113,Dallas,53061,Snohomish,WA,Seattle,62,3197000,51564.51612903226,100,4365000,43650.0,-38,-1168000
2016,county,48121,Denton,53061,Snohomish,WA,Seattle,71,3347000,47140.84507042253,47,2014000,42851.063829787236,24,1333000
2016,county,48085,Collin,53061,Snohomish,WA,Seattle,98,3856000,39346.93877551021,61,2420000,39672.13114754098,37,1436000
2016,county,48439,Tarrant,06095,Solano,CA,Bay Area,73,1901000,26041.095890410958,40,829000,20725.0,33,1072000
2016,county,48439,Tarrant,29183,St. Charles,MO,St. Louis,101,3431000,33970.29702970297,50,1823000,36460.0,51,1608000
2016,county,48113,Dallas,29183,St. Charles,MO,St. Louis,79,2987000,37810.126582278484,37,1500000,40540.54054054054,42,1487000
2016,county,48439,Tarrant,29189,St. Louis,MO,St. Louis,258,8373000,32453.488372093023,143,4556000,31860.13986013986,115,3817000
2016,county,48113,Dallas,29189,St. Louis,MO,St. Louis,366,18324000,50065.57377049181,190,15602000,82115.78947368421,176,2722000
2016,county,48121,Denton,29189,St. Louis,MO,St. Louis,134,5745000,42873.13432835821,72,2202000,30583.333333333332,62,3543000
2016,county,48085,Collin,29189,St. Louis,MO,St. Louis,262,9668000,36900.763358778626,88,4650000,52840.90909090909,174,5018000
2016,county,48113,Dallas,29510,St. Louis city,MO,Rural Missouri,150,4732000,31546.666666666668,63,2476000,39301.5873015873,87,2256000
2016,county,48439,Tarrant,22103,St. Tammany Parish,LA,New Orleans,67,2188000,32656.716417910447,70,2115000,30214.285714285714,-3,73000
2016,county,48113,Dallas,22103,St. Tammany Parish,LA,New Orleans,67,3838000,57283.58208955224,74,3020000,40810.81081081081,-7,818000
2016,county,48439,Tarrant,36103,Suffolk,NY,New York,110,4062000,36927.27272727273,40,1319000,32975.0,70,2743000
2016,county,48439,Tarrant,25025,Suffolk,MA,Boston,61,2184000,35803.27868852459,40,1939000,48475.0,21,245000
2016,county,48113,Dallas,25025,Suffolk,MA,Boston,160,10084000,63025.0,81,8449000,104308.64197530864,79,1635000
2016,county,48113,Dallas,36103,Suffolk,NY,New York,141,7392000,52425.53191489362,52,1352000,26000.0,89,6040000
2016,county,48439,Tarrant,39153,Summit,OH,Rural Ohio,60,2696000,44933.333333333336,47,1466000,31191.489361702126,13,1230000
2016,county,48113,Dallas,39153,Summit,OH,Rural Ohio,53,1339000,25264.150943396227,53,1606000,30301.88679245283,0,-267000
2016,county,48113,Dallas,48439,Tarrant,TX,Dallas-Fort Worth,18852,494549000,26233.23785274772,23251,635272000,27322.35172680745,-4399,-140723000
2016,county,48121,Denton,48439,Tarrant,TX,Dallas-Fort Worth,8162,309664000,37939.720656701786,6944,226772000,32657.25806451613,1218,82892000
2016,county,48085,Collin,48439,Tarrant,TX,Dallas-Fort Worth,2677,92641000,34606.275681733285,2481,89009000,35876.25957275292,196,3632000
2016,county,48439,Tarrant,48441,Taylor,TX,Rural Texas,457,10221000,22365.426695842452,301,6156000,20451.827242524916,156,4065000
2016,county,48113,Dallas,48441,Taylor,TX,Rural Texas,202,4827000,23896.039603960395,170,3980000,23411.764705882353,32,847000
2016,county,48121,Denton,48441,Taylor,TX,Rural Texas,144,3429000,23812.5,89,1846000,20741.573033707864,55,1583000
2016,county,48085,Collin,48441,Taylor,TX,Rural Texas,112,2987000,26669.64285714286,63,1613000,25603.174603174604,49,1374000
2016,county,48113,Dallas,48449,Titus,TX,Rural Texas,86,1135000,13197.67441860465,58,1166000,20103.44827586207,28,-31000
2016,county,48439,Tarrant,48451,Tom Green,TX,Rural Texas,181,4100000,22651.933701657457,128,2215000,17304.6875,53,1885000
2016,county,48113,Dallas,48451,Tom Green,TX,Rural Texas,103,2551000,24766.990291262136,93,2081000,22376.344086021505,10,470000
2016,county,48121,Denton,48451,Tom Green,TX,Rural Texas,82,2537000,30939.024390243903,51,1261000,24725.49019607843,31,1276000
2016,county,48439,Tarrant,48453,Travis,TX,Austin,1488,54361000,36532.93010752688,1249,47663000,38160.928742994394,239,6698000
2016,county,48113,Dallas,48453,Travis,TX,Austin,2736,113772000,41583.333333333336,2176,108507000,49865.34926470588,560,5265000
2016,county,48121,Denton,48453,Travis,TX,Austin,608,24864000,40894.73684210526,694,28785000,41476.94524495677,-86,-3921000
2016,county,48085,Collin,48453,Travis,TX,Austin,870,36438000,41882.75862068965,725,37588000,51845.51724137931,145,-1150000
2016,county,48439,Tarrant,40143,Tulsa,OK,Tulsa,458,16899000,36897.37991266375,353,10283000,29130.31161473088,105,6616000
2016,county,48113,Dallas,40143,Tulsa,OK,Tulsa,508,20395000,40147.637795275594,340,12723000,37420.58823529412,168,7672000
2016,county,48121,Denton,40143,Tulsa,OK,Tulsa,254,10856000,42740.15748031496,146,5130000,35136.98630136986,108,5726000
2016,county,48085,Collin,40143,Tulsa,OK,Tulsa,361,16555000,45858.725761772854,180,5547000,30816.666666666668,181,11008000
2016,county,48439,Tarrant,49049,Utah,UT,Rural Utah,103,1602000,15553.398058252427,107,2182000,20392.52336448598,-4,-580000
2016,county,48113,Dallas,49049,Utah,UT,Rural Utah,90,2051000,22788.88888888889,92,2191000,23815.217391304348,-2,-140000
2016,county,48121,Denton,49049,Utah,UT,Rural Utah,112,2854000,25482.14285714286,103,5578000,54155.33980582524,9,-2724000
2016,county,48085,Collin,49049,Utah,UT,Rural Utah,127,3525000,27755.905511811023,106,2228000,21018.867924528302,21,1297000
2016,county,48439,Tarrant,48465,Val Verde,TX,Rural Texas,60,771000,12850.0,62,846000,13645.161290322581,-2,-75000
2016,county,48439,Tarrant,48467,Van Zandt,TX,Rural Texas,71,2188000,30816.901408450703,128,3537000,27632.8125,-57,-1349000
2016,county,48113,Dallas,48467,Van Zandt,TX,Rural Texas,204,4118000,20186.274509803923,465,11302000,24305.37634408602,-261,-7184000
2016,county,48121,Denton,48467,Van Zandt,TX,Rural Texas,42,1139000,27119.04761904762,85,2033000,23917.647058823528,-43,-894000
2016,county,48085,Collin,48467,Van Zandt,TX,Rural Texas,70,2090000,29857.14285714286,114,4000000,35087.71929824561,-44,-1910000
2016,county,48439,Tarrant,06111,Ventura,CA,Los Angeles,131,4794000,36595.419847328245,78,3520000,45128.205128205125,53,1274000
2016,county,48113,Dallas,06111,Ventura,CA,Los Angeles,109,4942000,45339.449541284404,56,2269000,40517.857142857145,53,2673000
2016,county,48121,Denton,06111,Ventura,CA,Los Angeles,71,4566000,64309.859154929574,46,1250000,27173.91304347826,25,3316000
2016,county,48439,Tarrant,48469,Victoria,TX,Rural Texas,62,1941000,31306.451612903227,69,1851000,26826.08695652174,-7,90000
2016,county,48439,Tarrant,51810,Virginia Beach city,VA,Hampton Roads,157,3374000,21490.445859872612,85,1861000,21894.117647058825,72,1513000
2016,county,48113,Dallas,51810,Virginia Beach city,VA,Hampton Roads,62,1943000,31338.709677419356,59,1275000,21610.169491525423,3,668000
2016,county,48439,Tarrant,12127,Volusia,FL,Atlantic Coast,57,1234000,21649.122807017542,69,2746000,39797.10144927536,-12,-1512000
2016,county,48113,Dallas,12127,Volusia,FL,Atlantic Coast,63,1502000,23841.26984126984,34,1285000,37794.117647058825,29,217000
2016,county,48439,Tarrant,37183,Wake,NC,Raleigh,119,4477000,37621.8487394958,129,6177000,47883.72093023256,-10,-1700000
2016,county,48113,Dallas,37183,Wake,NC,Raleigh,165,6304000,38206.06060606061,162,8477000,52327.16049382716,3,-2173000
2016,county,48121,Denton,37183,Wake,NC,Raleigh,99,4066000,41070.707070707074,65,3711000,57092.307692307695,34,355000
2016,county,48085,Collin,37183,Wake,NC,Raleigh,105,3612000,34400.0,130,4984000,38338.46153846154,-25,-1372000
2016,county,48439,Tarrant,48471,Walker,TX,Rural Texas,70,1155000,16500.0,65,1065000,16384.615384615383,5,90000
2016,county,48113,Dallas,48471,Walker,TX,Rural Texas,55,1308000,23781.81818181818,72,1232000,17111.11111111111,-17,76000
2016,county,48113,Dallas,48473,Waller,TX,Houston,32,260000,8125.0,38,626000,16473.684210526317,-6,-366000
2016,county,48439,Tarrant,05143,Washington,AR,Rural Arkansas,84,2198000,26166.666666666668,53,1829000,34509.43396226415,31,369000
2016,county,48439,Tarrant,41067,Washington,OR,Portland,61,2029000,33262.29508196721,55,1557000,28309.090909090908,6,472000
2016,county,48113,Dallas,05143,Washington,AR,Rural Arkansas,151,4433000,29357.615894039736,93,3002000,32279.56989247312,58,1431000
2016,county,48113,Dallas,41067,Washington,OR,Portland,91,4653000,51131.868131868134,122,5508000,45147.54098360656,-31,-855000
2016,county,48121,Denton,05143,Washington,AR,Rural Arkansas,39,1217000,31205.128205128207,57,1973000,34614.0350877193,-18,-756000
2016,county,48085,Collin,41067,Washington,OR,Portland,120,3768000,31400.0,69,2524000,36579.710144927536,51,1244000
2016,county,48085,Collin,05143,Washington,AR,Rural Arkansas,32,652000,20375.0,45,1464000,32533.333333333332,-13,-812000
2016,county,48439,Tarrant,32031,Washoe,NV,Rural Nevada,89,808000,9078.651685393259,73,2263000,31000.0,16,-1455000
2016,county,48113,Dallas,32031,Washoe,NV,Rural Nevada,57,2172000,38105.26315789474,53,2056000,38792.45283018868,4,116000
2016,county,48113,Dallas,26161,Washtenaw,MI,Rural Michigan,79,3628000,45924.05063291139,48,2228000,46416.666666666664,31,1400000
2016,county,48113,Dallas,55133,Waukesha,WI,Milwaukee,43,2620000,60930.232558139534,40,1696000,42400.0,3,924000
2016,county,48439,Tarrant,26163,Wayne,MI,Detroit,194,6319000,32572.164948453606,120,1946000,16216.666666666666,74,4373000
2016,county,48113,Dallas,26163,Wayne,MI,Detroit,176,4648000,26409.090909090908,102,2336000,22901.960784313724,74,2312000
2016,county,48121,Denton,26163,Wayne,MI,Detroit,75,2613000,34840.0,51,1496000,29333.333333333332,24,1117000
2016,county,48085,Collin,26163,Wayne,MI,Detroit,120,3090000,25750.0,63,1671000,26523.809523809523,57,1419000
2016,county,48439,Tarrant,48479,Webb,TX,Rural Texas,109,1606000,14733.944954128441,53,699000,13188.67924528302,56,907000
2016,county,48113,Dallas,48479,Webb,TX,Rural Texas,212,2643000,12466.981132075472,187,2634000,14085.561497326204,25,9000
2016,county,48439,Tarrant,08123,Weld,CO,Rural Colorado,46,1091000,23717.391304347828,69,1803000,26130.434782608696,-23,-712000
2016,county,48113,Dallas,36119,Westchester,NY,New York,103,8822000,85650.4854368932,61,7327000,120114.75409836066,42,1495000
2016,county,48439,Tarrant,48485,Wichita,TX,Rural Texas,430,10057000,23388.372093023256,290,5800000,20000.0,140,4257000
2016,county,48113,Dallas,48485,Wichita,TX,Rural Texas,280,6532000,23328.571428571428,188,4714000,25074.468085106382,92,1818000
2016,county,48121,Denton,48485,Wichita,TX,Rural Texas,173,5188000,29988.43930635838,125,3040000,24320.0,48,2148000
2016,county,48085,Collin,48485,Wichita,TX,Rural Texas,137,4587000,33481.75182481752,57,1516000,26596.491228070176,80,3071000
2016,county,48439,Tarrant,48491,Williamson,TX,Austin,500,16077000,32154.0,559,20337000,36381.03756708408,-59,-4260000
2016,county,48439,Tarrant,47187,Williamson,TN,Nashville,67,3509000,52373.13432835821,50,1869000,37380.0,17,1640000
2016,county,48113,Dallas,48491,Williamson,TX,Austin,375,14073000,37528.0,533,20355000,38189.49343339587,-158,-6282000
2016,county,48113,Dallas,47187,Williamson,TN,Nashville,42,2684000,63904.76190476191,89,3956000,44449.43820224719,-47,-1272000
2016,county,48121,Denton,48491,Williamson,TX,Austin,344,12145000,35305.232558139534,354,12959000,36607.34463276836,-10,-814000
2016,county,48085,Collin,48491,Williamson,TX,Austin,371,15315000,41280.32345013477,417,19995000,47949.640287769784,-46,-4680000
2016,county,48439,Tarrant,48497,Wise,TX,Dallas-Fort Worth,862,23101000,26799.303944315547,1768,48766000,27582.57918552036,-906,-25665000
2016,county,48113,Dallas,48497,Wise,TX,Dallas-Fort Worth,107,3062000,28616.82242990654,177,4877000,27553.67231638418,-70,-1815000
2016,county,48121,Denton,48497,Wise,TX,Dallas-Fort Worth,373,9603000,25745.308310991957,711,21213000,29835.443037974685,-338,-11610000
2016,county,48085,Collin,48497,Wise,TX,Dallas-Fort Worth,43,1625000,37790.6976744186,69,2625000,38043.47826086957,-26,-1000000
2016,county,48439,Tarrant,48499,Wood,TX,Rural Texas,82,1476000,18000.0,119,2999000,25201.680672268907,-37,-1523000
2016,county,48113,Dallas,48499,Wood,TX,Rural Texas,82,2693000,32841.46341463415,210,7646000,36409.52380952381,-128,-4953000
2016,county,48085,Collin,48499,Wood,TX,Rural Texas,60,2109000,35150.0,122,5656000,46360.65573770492,-62,-3547000
2016,county,48113,Dallas,20209,Wyandotte,KS,Kansas City,47,587000,12489.36170212766,51,600000,11764.70588235294,-4,-13000
2016,county,48439,Tarrant,48503,Young,TX,Rural Texas,63,1588000,25206.349206349205,75,1763000,23506.666666666668,-12,-175000
2016,total,48439,Tarrant,96000,,,,102848,3192202000,31038.056160547603,91225,2928118000,32097.75828994245,11623,264084000
2016,total,48113,Dallas,96000,,,,119941,4208440000,35087.5847291585,128560,4582283000,35643.14716863721,-8619,-373843000
2016,total,48121,Denton,96000,,,,67645,2655880000,39262.02971394781,52299,1853700000,35444.272357024034,15346,802180000
2016,total,48085,Collin,96000,,,,73709,2974482000,40354.39362900053,58859,2432661000,41330.31482016344,14850,541821000
2017,county,48439,Tarrant,16001,Ada,ID,Rural Idaho,73,1059000,14506.849315068494,128,5807000,45367.1875,-55,-4748000
2017,county,48113,Dallas,16001,Ada,ID,Rural Idaho,43,1568000,36465.11627906977,57,3841000,67385.9649122807,-14,-2273000
2017,county,48121,Denton,16001,Ada,ID,Rural Idaho,49,2061000,42061.22448979592,40,1786000,44650.0,9,275000
2017,county,48085,Collin,16001,Ada,ID,Rural Idaho,63,2172000,34476.19047619047,59,2268000,38440.67796610169,4,-96000
2017,county,48439,Tarrant,08001,Adams,CO,Denver,247,6117000,24765.18218623482,140,4037000,28835.714285714286,107,2080000
2017,county,48113,Dallas,08001,Adams,CO,Denver,107,2852000,26654.205607476637,153,5351000,34973.856209150326,-46,-2499000
2017,county,48121,Denton,08001,Adams,CO,Denver,75,1966000,26213.333333333332,73,3199000,43821.91780821918,2,-1233000
2017,county,48085,Collin,08001,Adams,CO,Denver,60,2494000,41566.666666666664,74,2482000,33540.54054054054,-14,12000
2017,county,48439,Tarrant,06001,Alameda,CA,Bay Area,262,12384000,47267.17557251908,125,4826000,38608.0,137,7558000
2017,county,48113,Dallas,06001,Alameda,CA,Bay Area,406,18152000,44709.35960591133,263,13546000,51505.70342205323,143,4606000
2017,county,48121,Denton,06001,Alameda,CA,Bay Area,211,12158000,57620.85308056872,87,4256000,48919.54022988506,124,7902000
2017,county,48085,Collin,06001,Alameda,CA,Bay Area,520,26977000,51878.846153846156,195,9425000,48333.333333333336,325,17552000
2017,county,48439,Tarrant,51510,Alexandria city,VA,D.C.,68,2884000,42411.76470588235,48,3219000,67062.5,20,-335000
2017,county,48113,Dallas,51510,Alexandria city,VA,D.C.,95,4816000,50694.73684210526,53,4686000,88415.09433962264,42,130000
2017,county,48439,Tarrant,42003,Allegheny,PA,Pittsburgh,158,7483000,47360.759493670885,101,4461000,44168.316831683165,57,3022000
2017,county,48113,Dallas,42003,Allegheny,PA,Pittsburgh,183,9790000,53497.26775956284,128,6508000,50843.75,55,3282000
2017,county,48121,Denton,42003,Allegheny,PA,Pittsburgh,82,3798000,46317.07317073171,54,2388000,44222.22222222222,28,1410000
2017,county,48085,Collin,42003,Allegheny,PA,Pittsburgh,117,4549000,38880.34188034188,71,5212000,73408.45070422535,46,-663000
2017,county,48439,Tarrant,18003,Allen,IN,Rural Indiana,65,1453000,22353.846153846152,66,2051000,31075.757575757576,-1,-598000
2017,county,48113,Dallas,18003,Allen,IN,Rural Indiana,67,2339000,34910.44776119403,118,947000,8025.423728813559,-51,1392000
2017,county,48439,Tarrant,02020,Anchorage Borough,AK,Rural Alaska,91,2260000,24835.164835164836,55,1210000,22000.0,36,1050000
2017,county,48113,Dallas,02020,Anchorage Borough,AK,Rural Alaska,107,2840000,26542.056074766355,55,1358000,24690.909090909092,52,1482000
2017,county,48439,Tarrant,48001,Anderson,TX,Rural Texas,86,1129000,13127.906976744185,138,3200000,23188.405797101448,-52,-2071000
2017,county,48113,Dallas,48001,Anderson,TX,Rural Texas,143,2798000,19566.433566433567,134,2804000,20925.373134328358,9,-6000
2017,county,48121,Denton,48001,Anderson,TX,Rural Texas,53,1085000,20471.69811320755,46,822000,17869.565217391304,7,263000
2017,county,48439,Tarrant,48005,Angelina,TX,Rural Texas,106,1817000,17141.509433962263,57,1428000,25052.63157894737,49,389000
2017,county,48113,Dallas,48005,Angelina,TX,Rural Texas,131,3186000,24320.6106870229,73,1417000,19410.95890410959,58,1769000
2017,county,48439,Tarrant,24003,Anne Arundel,MD,Baltimore,86,3984000,46325.58139534884,76,2764000,36368.42105263158,10,1220000
2017,county,48113,Dallas,24003,Anne Arundel,MD,Baltimore,90,3125000,34722.22222222222,78,2577000,33038.46153846154,12,548000
2017,county,48085,Collin,24003,Anne Arundel,MD,Baltimore,132,3205000,24280.303030303032,44,2226000,50590.90909090909,88,979000
2017,county,48439,Tarrant,08005,Arapahoe,CO,Denver,341,8354000,24498.533724340177,254,7114000,28007.87401574803,87,1240000
2017,county,48113,Dallas,08005,Arapahoe,CO,Denver,311,12149000,39064.308681672024,278,12760000,45899.28057553957,33,-611000
2017,county,48121,Denton,08005,Arapahoe,CO,Denver,202,8904000,44079.207920792076,114,4845000,42500.0,88,4059000
2017,county,48085,Collin,08005,Arapahoe,CO,Denver,248,8838000,35637.096774193546,194,10813000,55737.113402061856,54,-1975000
2017,county,48439,Tarrant,51013,Arlington,VA,D.C.,58,3690000,63620.68965517241,55,2967000,53945.454545454544,3,723000
2017,county,48113,Dallas,51013,Arlington,VA,D.C.,137,9190000,67080.29197080292,106,14640000,138113.20754716982,31,-5450000
2017,county,48439,Tarrant,01003,Baldwin,AL,Mobile,56,1384000,24714.285714285714,47,995000,21170.212765957447,9,389000
2017,county,48439,Tarrant,24005,Baltimore,MD,Baltimore,101,4154000,41128.71287128713,80,1847000,23087.5,21,2307000
2017,county,48113,Dallas,24005,Baltimore,MD,Baltimore,139,5121000,36841.72661870503,81,2363000,29172.83950617284,58,2758000
2017,county,48439,Tarrant,24510,Baltimore city,MD,Baltimore,51,1996000,39137.25490196078,34,1507000,44323.529411764706,17,489000
2017,county,48113,Dallas,24510,Baltimore city,MD,Baltimore,110,6133000,55754.545454545456,44,1704000,38727.27272727273,66,4429000
2017,county,48439,Tarrant,48021,Bastrop,TX,Austin,57,1344000,23578.947368421053,44,1405000,31931.81818181818,13,-61000
2017,county,48113,Dallas,48021,Bastrop,TX,Austin,39,1224000,31384.615384615383,59,2254000,38203.38983050847,-20,-1030000
2017,county,48439,Tarrant,12005,Bay,FL,FL Panhandle,74,1166000,15756.756756756757,43,1420000,33023.25581395349,31,-254000
2017,county,48113,Dallas,12005,Bay,FL,FL Panhandle,53,1226000,23132.075471698114,32,1596000,49875.0,21,-370000
2017,county,48439,Tarrant,45013,Beaufort,SC,Savannah,91,2557000,28098.9010989011,53,2707000,51075.47169811321,38,-150000
2017,county,48439,Tarrant,48027,Bell,TX,Rural Texas,799,17330000,21689.612015018774,620,14128000,22787.09677419355,179,3202000
2017,county,48113,Dallas,48027,Bell,TX,Rural Texas,598,15282000,25555.183946488294,498,10682000,21449.79919678715,100,4600000
2017,county,48121,Denton,48027,Bell,TX,Rural Texas,355,9169000,25828.169014084506,237,5259000,22189.87341772152,118,3910000
2017,county,48085,Collin,48027,Bell,TX,Rural Texas,279,7636000,27369.175627240144,146,5518000,37794.520547945205,133,2118000
2017,county,48439,Tarrant,05007,Benton,AR,Rural Arkansas,157,5266000,33541.40127388535,215,7508000,34920.93023255814,-58,-2242000
2017,county,48113,Dallas,05007,Benton,AR,Rural Arkansas,214,13302000,62158.878504672895,193,7952000,41202.072538860106,21,5350000
2017,county,48121,Denton,05007,Benton,AR,Rural Arkansas,138,6113000,44297.10144927536,164,6239000,38042.68292682927,-26,-126000
2017,county,48085,Collin,05007,Benton,AR,Rural Arkansas,246,12952000,52650.40650406504,189,9579000,50682.53968253968,57,3373000
2017,county,48113,Dallas,34003,Bergen,NJ,New York,123,5495000,44674.79674796748,78,3172000,40666.666666666664,45,2323000
2017,county,48085,Collin,34003,Bergen,NJ,New York,187,8507000,45491.978609625665,70,3955000,56500.0,117,4552000
2017,county,48439,Tarrant,35001,Bernalillo,NM,Albuquerque,288,7620000,26458.333333333332,167,3995000,23922.155688622755,121,3625000
2017,county,48113,Dallas,35001,Bernalillo,NM,Albuquerque,268,8475000,31623.13432835821,143,6796000,47524.47552447552,125,1679000
2017,county,48121,Denton,35001,Bernalillo,NM,Albuquerque,149,5209000,34959.73154362416,63,3052000,48444.444444444445,86,2157000
2017,county,48085,Collin,35001,Bernalillo,NM,Albuquerque,150,4216000,28106.666666666668,74,2878000,38891.89189189189,76,1338000
2017,county,48439,Tarrant,48029,Bexar,TX,San Antonio,1691,50640000,29946.777054997045,1353,39248000,29008.130081300813,338,11392000
2017,county,48113,Dallas,48029,Bexar,TX,San Antonio,1861,73002000,39227.29715206878,1610,57843000,35927.32919254658,251,15159000
2017,county,48121,Denton,48029,Bexar,TX,San Antonio,789,26793000,33958.17490494296,679,22962000,33817.378497790865,110,3831000
2017,county,48085,Collin,48029,Bexar,TX,San Antonio,1096,39294000,35852.189781021894,629,22568000,35879.17329093799,467,16726000
2017,county,48439,Tarrant,29019,Boone,MO,Columbia,65,2110000,32461.53846153846,64,1220000,19062.5,1,890000
2017,county,48439,Tarrant,48035,Bosque,TX,Rural Texas,51,1480000,29019.607843137255,119,5149000,43268.90756302521,-68,-3669000
2017,county,48439,Tarrant,22015,Bossier Parish,LA,Rural Louisiana,206,4305000,20898.058252427185,113,2361000,20893.805309734515,93,1944000
2017,county,48113,Dallas,22015,Bossier Parish,LA,Rural Louisiana,269,5284000,19643.122676579926,137,2777000,20270.07299270073,132,2507000
2017,county,48121,Denton,22015,Bossier Parish,LA,Rural Louisiana,101,2408000,23841.58415841584,57,1532000,26877.19298245614,44,876000
2017,county,48439,Tarrant,08013,Boulder,CO,Denver,55,1933000,35145.454545454544,91,2535000,27857.14285714286,-36,-602000
2017,county,48113,Dallas,08013,Boulder,CO,Denver,68,3733000,54897.05882352941,116,8241000,71043.10344827586,-48,-4508000
2017,county,48085,Collin,08013,Boulder,CO,Denver,65,3978000,61200.0,49,3469000,70795.91836734694,16,509000
2017,county,48439,Tarrant,48037,Bowie,TX,Rural Texas,169,3161000,18704.14201183432,135,2191000,16229.62962962963,34,970000
2017,county,48113,Dallas,48037,Bowie,TX,Rural Texas,220,4877000,22168.18181818182,203,3677000,18113.300492610837,17,1200000
2017,county,48121,Denton,48037,Bowie,TX,Rural Texas,53,1737000,32773.58490566038,82,2039000,24865.853658536584,-29,-302000
2017,county,48085,Collin,48037,Bowie,TX,Rural Texas,115,3184000,27686.956521739132,105,3307000,31495.238095238095,10,-123000
2017,county,48439,Tarrant,48039,Brazoria,TX,Houston,182,5245000,28818.68131868132,176,5313000,30187.5,6,-68000
2017,county,48113,Dallas,48039,Brazoria,TX,Houston,160,5080000,31750.0,216,6422000,29731.48148148148,-56,-1342000
2017,county,48121,Denton,48039,Brazoria,TX,Houston,125,4030000,32240.0,97,2631000,27123.711340206184,28,1399000
2017,county,48085,Collin,48039,Brazoria,TX,Houston,117,4224000,36102.5641025641,102,3437000,33696.07843137255,15,787000
2017,county,48439,Tarrant,48041,Brazos,TX,Rural Texas,350,9543000,27265.714285714286,284,8727000,30728.87323943662,66,816000
2017,county,48113,Dallas,48041,Brazos,TX,Rural Texas,441,10860000,24625.850340136054,314,11158000,35535.03184713376,127,-298000
2017,county,48121,Denton,48041,Brazos,TX,Rural Texas,207,5241000,25318.840579710144,129,4674000,36232.558139534885,78,567000
2017,county,48085,Collin,48041,Brazos,TX,Rural Texas,261,7595000,29099.616858237547,170,7190000,42294.117647058825,91,405000
2017,county,48439,Tarrant,12009,Brevard,FL,Atlantic Coast,98,3057000,31193.877551020407,214,12299000,57471.96261682243,-116,-9242000
2017,county,48113,Dallas,12009,Brevard,FL,Atlantic Coast,53,1717000,32396.22641509434,86,3412000,39674.41860465116,-33,-1695000
2017,county,48121,Denton,12009,Brevard,FL,Atlantic Coast,45,1435000,31888.88888888889,68,3693000,54308.82352941176,-23,-2258000
2017,county,48085,Collin,12009,Brevard,FL,Atlantic Coast,63,2213000,35126.98412698413,151,6875000,45529.801324503314,-88,-4662000
2017,county,48113,Dallas,36005,Bronx,NY,New York,184,3022000,16423.91304347826,50,1238000,24760.0,134,1784000
2017,county,48439,Tarrant,12011,Broward,FL,Miami,387,10314000,26651.162790697676,250,13301000,53204.0,137,-2987000
2017,county,48113,Dallas,12011,Broward,FL,Miami,473,19998000,42279.06976744186,288,16858000,58534.72222222222,185,3140000
2017,county,48121,Denton,12011,Broward,FL,Miami,242,12351000,51037.19008264463,157,7298000,46484.076433121016,85,5053000
2017,county,48085,Collin,12011,Broward,FL,Miami,281,12586000,44790.03558718861,180,11039000,61327.77777777778,101,1547000
2017,county,48439,Tarrant,48049,Brown,TX,Rural Texas,113,2092000,18513.274336283186,114,3964000,34771.929824561405,-1,-1872000
2017,county,48113,Dallas,48049,Brown,TX,Rural Texas,42,661000,15738.095238095239,41,1013000,24707.317073170732,1,-352000
2017,county,48439,Tarrant,40013,Bryan,OK,Rural Oklahoma,53,642000,12113.207547169812,46,1163000,25282.608695652172,7,-521000
2017,county,48113,Dallas,40013,Bryan,OK,Rural Oklahoma,70,1085000,15500.0,66,1845000,27954.545454545456,4,-760000
2017,county,48085,Collin,40013,Bryan,OK,Rural Oklahoma,65,2596000,39938.46153846154,82,2128000,25951.219512195123,-17,468000
2017,county,48439,Tarrant,42017,Bucks,PA,Philadelphia,57,2513000,44087.71929824561,64,5662000,88468.75,-7,-3149000
2017,county,48113,Dallas,42017,Bucks,PA,Philadelphia,42,1714000,40809.52380952381,51,1631000,31980.392156862745,-9,83000
2017,county,48439,Tarrant,34005,Burlington,NJ,Philadelphia,107,2123000,19841.1214953271,54,1406000,26037.037037037036,53,717000
2017,county,48439,Tarrant,39017,Butler,OH,Cincinnati,59,1906000,32305.084745762713,78,1180000,15128.205128205129,-19,726000
2017,county,48439,Tarrant,22017,Caddo Parish,LA,Rural Louisiana,576,11771000,20435.76388888889,189,3249000,17190.47619047619,387,8522000
2017,county,48113,Dallas,22017,Caddo Parish,LA,Rural Louisiana,753,15190000,20172.642762284195,286,5345000,18688.81118881119,467,9845000
2017,county,48121,Denton,22017,Caddo Parish,LA,Rural Louisiana,211,4591000,21758.29383886256,90,1301000,14455.555555555555,121,3290000
2017,county,48085,Collin,22017,Caddo Parish,LA,Rural Louisiana,215,5265000,24488.372093023256,62,1254000,20225.8064516129,153,4011000
2017,county,48439,Tarrant,22019,Calcasieu Parish,LA,Rural Louisiana,68,1124000,16529.41176470588,32,961000,30031.25,36,163000
2017,county,48113,Dallas,22019,Calcasieu Parish,LA,Rural Louisiana,64,1204000,18812.5,45,1148000,25511.11111111111,19,56000
2017,county,48439,Tarrant,48061,Cameron,TX,Rural Texas,231,5546000,24008.658008658007,170,3599000,21170.58823529412,61,1947000
2017,county,48113,Dallas,48061,Cameron,TX,Rural Texas,302,5810000,19238.41059602649,214,3668000,17140.18691588785,88,2142000
2017,county,48121,Denton,48061,Cameron,TX,Rural Texas,91,2253000,24758.24175824176,54,1449000,26833.333333333332,37,804000
2017,county,48439,Tarrant,40017,Canadian,OK,Oklahoma City,121,4023000,33247.93388429752,153,5223000,34137.25490196078,-32,-1200000
2017,county,48113,Dallas,40017,Canadian,OK,Oklahoma City,44,1581000,35931.818181818184,83,2065000,24879.518072289156,-39,-484000
2017,county,48121,Denton,40017,Canadian,OK,Oklahoma City,62,1570000,25322.58064516129,54,1358000,25148.14814814815,8,212000
2017,county,48439,Tarrant,40019,Carter,OK,Rural Oklahoma,65,1099000,16907.69230769231,37,864000,23351.35135135135,28,235000
2017,county,48113,Dallas,40019,Carter,OK,Rural Oklahoma,49,1088000,22204.081632653062,55,814000,14800.0,-6,274000
2017,county,48121,Denton,40019,Carter,OK,Rural Oklahoma,35,571000,16314.285714285714,32,1783000,55718.75,3,-1212000
2017,county,48439,Tarrant,45019,Charleston,SC,Charleston,53,1716000,32377.35849056604,61,7494000,122852.45901639345,-8,-5778000
2017,county,48113,Dallas,45019,Charleston,SC,Charleston,63,2192000,34793.65079365079,72,4003000,55597.22222222222,-9,-1811000
2017,county,48439,Tarrant,13051,Chatham,GA,Savannah,104,2713000,26086.53846153846,75,2461000,32813.333333333336,29,252000
2017,county,48113,Dallas,13051,Chatham,GA,Savannah,63,1990000,31587.301587301587,63,3685000,58492.06349206349,0,-1695000
2017,county,48439,Tarrant,13057,Cherokee,GA,Atlanta,51,1862000,36509.80392156863,61,1927000,31590.16393442623,-10,-65000
2017,county,48439,Tarrant,48073,Cherokee,TX,Rural Texas,64,982000,15343.75,50,1350000,27000.0,14,-368000
2017,county,48113,Dallas,48073,Cherokee,TX,Rural Texas,74,1214000,16405.405405405407,83,2211000,26638.55421686747,-9,-997000
2017,county,48439,Tarrant,51550,Chesapeake city,VA,Hampton Roads,51,1279000,25078.43137254902,54,1187000,21981.48148148148,-3,92000
2017,county,48113,Dallas,51550,Chesapeake city,VA,Hampton Roads,36,1002000,27833.333333333332,47,1482000,31531.91489361702,-11,-480000
2017,county,48113,Dallas,42029,Chester,PA,Philadelphia,64,3413000,53328.125,49,3182000,64938.77551020408,15,231000
2017,county,48085,Collin,42029,Chester,PA,Philadelphia,95,4955000,52157.89473684211,66,3084000,46727.27272727273,29,1871000
2017,county,48439,Tarrant,51041,Chesterfield,VA,Richmond,48,2344000,48833.333333333336,63,2024000,32126.984126984127,-15,320000
2017,county,48113,Dallas,51041,Chesterfield,VA,Richmond,56,1798000,32107.14285714286,32,1513000,47281.25,24,285000
2017,county,48439,Tarrant,41005,Clackamas,OR,Portland,35,935000,26714.285714285714,37,1945000,52567.56756756757,-2,-1010000
2017,county,48113,Dallas,41005,Clackamas,OR,Portland,45,1600000,35555.555555555555,42,2026000,48238.09523809524,3,-426000
2017,county,48439,Tarrant,32003,Clark,NV,Las Vegas,574,17074000,29745.644599303138,535,14052000,26265.420560747665,39,3022000
2017,county,48439,Tarrant,53011,Clark,WA,Portland,69,2323000,33666.666666666664,74,2627000,35500.0,-5,-304000
2017,county,48113,Dallas,32003,Clark,NV,Las Vegas,525,16338000,31120.0,543,20632000,37996.3167587477,-18,-4294000
2017,county,48113,Dallas,53011,Clark,WA,Portland,84,2959000,35226.19047619047,59,4192000,71050.84745762713,25,-1233000
2017,county,48121,Denton,32003,Clark,NV,Las Vegas,331,10921000,32993.957703927495,233,7559000,32442.06008583691,98,3362000
2017,county,48121,Denton,53011,Clark,WA,Portland,94,3872000,41191.48936170213,58,2315000,39913.793103448275,36,1557000
2017,county,48085,Collin,32003,Clark,NV,Las Vegas,390,14092000,36133.333333333336,290,12217000,42127.58620689655,100,1875000
2017,county,48085,Collin,53011,Clark,WA,Portland,105,4052000,38590.47619047619,61,3524000,57770.49180327869,44,528000
2017,county,48439,Tarrant,29047,Clay,MO,Kansas City,83,2420000,29156.626506024095,90,3051000,33900.0,-7,-631000
2017,county,48439,Tarrant,12019,Clay,FL,Jacksonville,72,1485000,20625.0,61,1325000,21721.311475409835,11,160000
2017,county,48113,Dallas,29047,Clay,MO,Kansas City,99,3041000,30717.171717171717,36,1480000,41111.11111111111,63,1561000
2017,county,48085,Collin,29047,Clay,MO,Kansas City,55,2397000,43581.818181818184,46,2613000,56804.34782608696,9,-216000
2017,county,48439,Tarrant,13063,Clayton,GA,Atlanta,72,1255000,17430.555555555555,42,695000,16547.619047619046,30,560000
2017,county,48113,Dallas,13063,Clayton,GA,Atlanta,76,1254000,16500.0,63,1016000,16126.984126984127,13,238000
2017,county,48439,Tarrant,40027,Cleveland,OK,Oklahoma City,236,7252000,30728.813559322032,224,6347000,28334.821428571428,12,905000
2017,county,48113,Dallas,40027,Cleveland,OK,Oklahoma City,263,9419000,35813.68821292776,128,4735000,36992.1875,135,4684000
2017,county,48121,Denton,40027,Cleveland,OK,Oklahoma City,149,5025000,33724.8322147651,104,2937000,28240.384615384617,45,2088000
2017,county,48085,Collin,40027,Cleveland,OK,Oklahoma City,183,6211000,33939.89071038251,91,2357000,25901.0989010989,92,3854000
2017,county,48439,Tarrant,13067,Cobb,GA,Atlanta,253,9525000,37648.22134387352,192,8689000,45255.208333333336,61,836000
2017,county,48113,Dallas,13067,Cobb,GA,Atlanta,285,11505000,40368.42105263158,252,9206000,36531.74603174603,33,2299000
2017,county,48121,Denton,13067,Cobb,GA,Atlanta,132,6779000,51356.06060606061,69,3292000,47710.14492753623,63,3487000
2017,county,48085,Collin,13067,Cobb,GA,Atlanta,175,7867000,44954.28571428572,104,4538000,43634.61538461538,71,3329000
2017,county,48439,Tarrant,12021,Collier,FL,S.W. Florida,54,3496000,64740.74074074074,39,2402000,61589.743589743586,15,1094000
2017,county,48113,Dallas,12021,Collier,FL,S.W. Florida,63,2554000,40539.68253968254,61,5800000,95081.96721311475,2,-3246000
2017,county,48439,Tarrant,48085,Collin,TX,Dallas-Fort Worth,3350,106552000,31806.567164179105,3958,139368000,35211.723092470944,-608,-32816000
2017,county,48113,Dallas,48085,Collin,TX,Dallas-Fort Worth,19022,904693000,47560.35117232678,28137,1057889000,37597.78938763905,-9115,-153196000
2017,county,48121,Denton,48085,Collin,TX,Dallas-Fort Worth,16535,741978000,44873.17810704566,14788,582605000,39397.146334866105,1747,159373000
2017,county,48439,Tarrant,48091,Comal,TX,San Antonio,134,4462000,33298.50746268657,235,8877000,37774.46808510638,-101,-4415000
2017,county,48113,Dallas,48091,Comal,TX,San Antonio,111,5405000,48693.69369369369,157,6915000,44044.58598726115,-46,-1510000
2017,county,48121,Denton,48091,Comal,TX,San Antonio,69,3753000,54391.30434782609,114,5407000,47429.82456140351,-45,-1654000
2017,county,48085,Collin,48091,Comal,TX,San Antonio,75,2767000,36893.333333333336,169,6483000,38360.94674556213,-94,-3716000
2017,county,48439,Tarrant,40031,Comanche,OK,Rural Oklahoma,160,3226000,20162.5,96,1815000,18906.25,64,1411000
2017,county,48439,Tarrant,48093,Comanche,TX,Rural Texas,34,658000,19352.941176470587,59,1844000,31254.237288135595,-25,-1186000
2017,county,48113,Dallas,40031,Comanche,OK,Rural Oklahoma,169,3939000,23307.69230769231,104,1639000,15759.615384615385,65,2300000
2017,county,48439,Tarrant,06013,Contra Costa,CA,Bay Area,231,19725000,85389.61038961039,129,4747000,36798.4496124031,102,14978000
2017,county,48113,Dallas,06013,Contra Costa,CA,Bay Area,214,11367000,53116.82242990654,146,7638000,52315.068493150684,68,3729000
2017,county,48121,Denton,06013,Contra Costa,CA,Bay Area,175,8321000,47548.57142857143,95,4463000,46978.94736842105,80,3858000
2017,county,48085,Collin,06013,Contra Costa,CA,Bay Area,238,13358000,56126.05042016807,96,5635000,58697.916666666664,142,7723000
2017,county,48439,Tarrant,17031,Cook,IL,Chicago,1084,35480000,32730.62730627306,458,17056000,37240.17467248908,626,18424000
2017,county,48113,Dallas,17031,Cook,IL,Chicago,1878,96256000,51254.52609158679,994,66316000,66716.29778672032,884,29940000
2017,county,48121,Denton,17031,Cook,IL,Chicago,562,24167000,43001.779359430606,220,8300000,37727.27272727273,342,15867000
2017,county,48085,Collin,17031,Cook,IL,Chicago,980,39980000,40795.91836734694,306,15075000,49264.705882352944,674,24905000
2017,county,48439,Tarrant,48097,Cooke,TX,Rural Texas,149,4152000,27865.771812080537,217,5329000,24557.603686635946,-68,-1177000
2017,county,48113,Dallas,48097,Cooke,TX,Rural Texas,72,2870000,39861.11111111111,145,4406000,30386.206896551725,-73,-1536000
2017,county,48121,Denton,48097,Cooke,TX,Rural Texas,573,13283000,23181.50087260035,1054,30173000,28627.134724857686,-481,-16890000
2017,county,48085,Collin,48097,Cooke,TX,Rural Texas,72,5968000,82888.88888888889,155,6809000,43929.032258064515,-83,-841000
2017,county,48439,Tarrant,48099,Coryell,TX,Rural Texas,146,2241000,15349.315068493152,110,1692000,15381.818181818182,36,549000
2017,county,48113,Dallas,48099,Coryell,TX,Rural Texas,83,1385000,16686.746987951807,103,1719000,16689.320388349515,-20,-334000
2017,county,48439,Tarrant,37049,Craven,NC,Rural North Carolina,59,1018000,17254.237288135595,50,1133000,22660.0,9,-115000
2017,county,48439,Tarrant,37051,Cumberland,NC,Rural North Carolina,113,2946000,26070.796460176993,41,773000,18853.658536585364,72,2173000
2017,county,48113,Dallas,37051,Cumberland,NC,Rural North Carolina,86,1697000,19732.558139534885,71,1401000,19732.394366197183,15,296000
2017,county,48113,Dallas,23005,Cumberland,ME,Portland,47,1504000,32000.0,37,2256000,60972.97297297297,10,-752000
2017,county,48439,Tarrant,39035,Cuyahoga,OH,Cleveland,103,2395000,23252.427184466018,107,2868000,26803.73831775701,-4,-473000
2017,county,48113,Dallas,39035,Cuyahoga,OH,Cleveland,143,7514000,52545.454545454544,128,12038000,94046.875,15,-4524000
2017,county,48121,Denton,39035,Cuyahoga,OH,Cleveland,72,3126000,43416.666666666664,29,1133000,39068.96551724138,43,1993000
2017,county,48085,Collin,39035,Cuyahoga,OH,Cleveland,120,4899000,40825.0,54,2262000,41888.88888888889,66,2637000
2017,county,48439,Tarrant,27037,Dakota,MN,Minneapolis,81,2711000,33469.135802469136,51,1424000,27921.56862745098,30,1287000
2017,county,48113,Dallas,27037,Dakota,MN,Minneapolis,112,3040000,27142.85714285714,63,2358000,37428.57142857143,49,682000
2017,county,48085,Collin,27037,Dakota,MN,Minneapolis,82,3548000,43268.29268292683,55,2812000,51127.27272727273,27,736000
2017,county,48439,Tarrant,48113,Dallas,TX,Dallas-Fort Worth,29810,830136000,27847.567930224755,23773,682602000,28713.330248601356,6037,147534000
2017,county,48121,Denton,48113,Dallas,TX,Dallas-Fort Worth,21981,833656000,37926.20899868068,14096,462319000,32797.88592508513,7885,371337000
2017,county,48085,Collin,48113,Dallas,TX,Dallas-Fort Worth,28137,1057889000,37597.78938763905,19022,904693000,47560.35117232678,9115,153196000
2017,county,48439,Tarrant,55025,Dane,WI,Madison,75,3221000,42946.666666666664,39,1518000,38923.07692307692,36,1703000
2017,county,48113,Dallas,55025,Dane,WI,Madison,108,4429000,41009.25925925926,62,2293000,36983.87096774193,46,2136000
2017,county,48121,Denton,55025,Dane,WI,Madison,74,2692000,36378.37837837838,34,1527000,44911.76470588235,40,1165000
2017,county,48085,Collin,55025,Dane,WI,Madison,73,2899000,39712.32876712329,43,1442000,33534.88372093023,30,1457000
2017,county,48439,Tarrant,47037,Davidson,TN,Nashville,197,5752000,29197.969543147206,153,5670000,37058.82352941176,44,82000
2017,county,48113,Dallas,47037,Davidson,TN,Nashville,261,11876000,45501.91570881226,311,19579000,62954.98392282958,-50,-7703000
2017,county,48121,Denton,47037,Davidson,TN,Nashville,62,2437000,39306.45161290323,78,3932000,50410.256410256414,-16,-1495000
2017,county,48085,Collin,47037,Davidson,TN,Nashville,131,7340000,56030.53435114504,97,5575000,57474.22680412371,34,1765000
2017,county,48439,Tarrant,49011,Davis,UT,Rural Utah,112,2389000,21330.35714285714,78,2690000,34487.179487179485,34,-301000
2017,county,48121,Denton,49011,Davis,UT,Rural Utah,69,2866000,41536.23188405797,66,2473000,37469.69696969697,3,393000
2017,county,48439,Tarrant,13089,DeKalb,GA,Atlanta,131,3839000,29305.34351145038,132,4488000,34000.0,-1,-649000
2017,county,48113,Dallas,13089,DeKalb,GA,Atlanta,301,13102000,43528.23920265781,285,9437000,33112.28070175439,16,3665000
2017,county,48121,Denton,13089,DeKalb,GA,Atlanta,63,2930000,46507.93650793651,78,3736000,47897.4358974359,-15,-806000
2017,county,48085,Collin,13089,DeKalb,GA,Atlanta,108,3652000,33814.81481481482,83,3274000,39445.78313253012,25,378000
2017,county,48439,Tarrant,28033,DeSoto,MS,Memphis,69,1501000,21753.623188405796,57,1374000,24105.263157894737,12,127000
2017,county,48113,Dallas,42045,Delaware,PA,Philadelphia,94,3786000,40276.59574468085,41,2125000,51829.26829268293,53,1661000
2017,county,48439,Tarrant,48121,Denton,TX,Dallas-Fort Worth,9307,321747000,34570.43085849361,12178,472734000,38818.68943997372,-2871,-150987000
2017,county,48113,Dallas,48121,Denton,TX,Dallas-Fort Worth,14096,462319000,32797.88592508513,21981,833656000,37926.20899868068,-7885,-371337000
2017,county,48085,Collin,48121,Denton,TX,Dallas-Fort Worth,14788,582605000,39397.146334866105,16535,741978000,44873.17810704566,-1747,-159373000
2017,county,48439,Tarrant,08031,Denver,CO,Denver,246,10039000,40808.9430894309,269,10570000,39293.68029739777,-23,-531000
2017,county,48113,Dallas,08031,Denver,CO,Denver,396,28226000,71277.77777777778,537,36790000,68510.24208566108,-141,-8564000
2017,county,48121,Denton,08031,Denver,CO,Denver,144,7476000,51916.666666666664,129,5752000,44589.1472868217,15,1724000
2017,county,48085,Collin,08031,Denver,CO,Denver,126,7739000,61420.63492063492,122,7002000,57393.44262295082,4,737000
2017,county,48439,Tarrant,11001,District of Columbia,DC,D.C.,58,4952000,85379.31034482758,68,3141000,46191.17647058824,-10,1811000
2017,county,48113,Dallas,11001,District of Columbia,DC,D.C.,246,20616000,83804.87804878049,205,15509000,75653.65853658537,41,5107000
2017,county,48121,Denton,11001,District of Columbia,DC,D.C.,31,2867000,92483.87096774194,30,1412000,47066.666666666664,1,1455000
2017,county,48085,Collin,11001,District of Columbia,DC,D.C.,46,1873000,40717.391304347824,35,1289000,36828.57142857143,11,584000
2017,county,48439,Tarrant,35013,Dona Ana,NM,Rural New Mexico,116,1959000,16887.931034482757,77,1267000,16454.545454545456,39,692000
2017,county,48113,Dallas,35013,Dona Ana,NM,Rural New Mexico,51,1516000,29725.49019607843,56,1762000,31464.285714285714,-5,-246000
2017,county,48439,Tarrant,31055,Douglas,NE,Omaha,200,5481000,27405.0,114,3642000,31947.36842105263,86,1839000
2017,county,48439,Tarrant,08035,Douglas,CO,Denver,177,9079000,51293.78531073446,168,7556000,44976.19047619047,9,1523000
2017,county,48113,Dallas,31055,Douglas,NE,Omaha,180,4708000,26155.555555555555,145,4184000,28855.172413793105,35,524000
2017,county,48113,Dallas,08035,Douglas,CO,Denver,96,4818000,50187.5,168,9200000,54761.90476190476,-72,-4382000
2017,county,48121,Denton,31055,Douglas,NE,Omaha,160,5305000,33156.25,76,2449000,32223.684210526317,84,2856000
2017,county,48121,Denton,08035,Douglas,CO,Denver,176,7248000,41181.818181818184,152,7235000,47598.68421052631,24,13000
2017,county,48085,Collin,08035,Douglas,CO,Denver,197,10770000,54670.05076142132,210,9661000,46004.76190476191,-13,1109000
2017,county,48085,Collin,31055,Douglas,NE,Omaha,103,4299000,41737.8640776699,100,3102000,31020.0,3,1197000
2017,county,48439,Tarrant,17043,DuPage,IL,Chicago,277,11807000,42624.54873646209,131,7255000,55381.67938931298,146,4552000
2017,county,48113,Dallas,17043,DuPage,IL,Chicago,312,15631000,50099.35897435898,157,8836000,56280.25477707006,155,6795000
2017,county,48121,Denton,17043,DuPage,IL,Chicago,171,8195000,47923.976608187135,81,3372000,41629.62962962963,90,4823000
2017,county,48085,Collin,17043,DuPage,IL,Chicago,349,16906000,48441.26074498567,124,5381000,43395.16129032258,225,11525000
2017,county,48113,Dallas,37063,Durham,NC,Raleigh,130,5377000,41361.53846153846,63,2511000,39857.142857142855,67,2866000
2017,county,48439,Tarrant,12031,Duval,FL,Jacksonville,257,7035000,27373.54085603113,172,5647000,32831.395348837206,85,1388000
2017,county,48113,Dallas,12031,Duval,FL,Jacksonville,290,10592000,36524.137931034486,243,10458000,43037.03703703704,47,134000
2017,county,48121,Denton,12031,Duval,FL,Jacksonville,104,4669000,44894.230769230766,111,3857000,34747.747747747744,-7,812000
2017,county,48085,Collin,12031,Duval,FL,Jacksonville,139,4436000,31913.669064748203,134,5443000,40619.40298507463,5,-1007000
2017,county,48439,Tarrant,22033,East Baton Rouge Parish,LA,Rural Louisiana,230,4923000,21404.347826086956,92,2587000,28119.565217391304,138,2336000
2017,county,48113,Dallas,22033,East Baton Rouge Parish,LA,Rural Louisiana,387,9281000,23981.91214470284,102,3874000,37980.39215686275,285,5407000
2017,county,48121,Denton,22033,East Baton Rouge Parish,LA,Rural Louisiana,138,3348000,24260.869565217392,55,1561000,28381.81818181818,83,1787000
2017,county,48085,Collin,22033,East Baton Rouge Parish,LA,Rural Louisiana,141,4116000,29191.489361702126,67,1250000,18656.716417910447,74,2866000
2017,county,48439,Tarrant,48133,Eastland,TX,Rural Texas,51,1339000,26254.901960784315,105,2421000,23057.14285714286,-54,-1082000
2017,county,48439,Tarrant,48135,Ector,TX,Rural Texas,342,9364000,27380.116959064326,205,5278000,25746.341463414636,137,4086000
2017,county,48113,Dallas,48135,Ector,TX,Rural Texas,275,6682000,24298.18181818182,115,2336000,20313.043478260868,160,4346000
2017,county,48085,Collin,48135,Ector,TX,Rural Texas,103,3240000,31456.31067961165,56,1080000,19285.714285714286,47,2160000
2017,county,48439,Tarrant,48141,El Paso,TX,El Paso,779,17265000,22163.029525032092,461,9965000,21616.052060737526,318,7300000
2017,county,48439,Tarrant,08041,El Paso,CO,Colorado Springs,320,6930000,21656.25,488,13260000,27172.131147540982,-168,-6330000
2017,county,48113,Dallas,48141,El Paso,TX,El Paso,780,16224000,20800.0,484,11172000,23082.644628099173,296,5052000
2017,county,48113,Dallas,08041,El Paso,CO,Colorado Springs,220,5994000,27245.454545454544,331,10970000,33141.993957703926,-111,-4976000
2017,county,48121,Denton,48141,El Paso,TX,El Paso,332,8449000,25448.795180722893,150,4172000,27813.333333333332,182,4277000
2017,county,48121,Denton,08041,El Paso,CO,Colorado Springs,174,5824000,33471.26436781609,257,8293000,32268.482490272374,-83,-2469000
2017,county,48085,Collin,48141,El Paso,TX,El Paso,291,8267000,28408.93470790378,154,3259000,21162.33766233766,137,5008000
2017,county,48085,Collin,08041,El Paso,CO,Colorado Springs,200,6087000,30435.0,266,10143000,38131.57894736842,-66,-4056000
2017,county,48439,Tarrant,48139,Ellis,TX,Dallas-Fort Worth,1329,41553000,31266.365688487585,2996,92835000,30986.315086782375,-1667,-51282000
2017,county,48113,Dallas,48139,Ellis,TX,Dallas-Fort Worth,2903,61034000,21024.457457802273,6214,155876000,25084.647570003217,-3311,-94842000
2017,county,48121,Denton,48139,Ellis,TX,Dallas-Fort Worth,295,7881000,26715.254237288136,529,17040000,32211.7202268431,-234,-9159000
2017,county,48085,Collin,48139,Ellis,TX,Dallas-Fort Worth,330,10649000,32269.696969696968,515,16412000,31867.961165048542,-185,-5763000
2017,county,48439,Tarrant,48143,Erath,TX,Rural Texas,274,6910000,25218.97810218978,248,6592000,26580.645161290322,26,318000
2017,county,48113,Dallas,48143,Erath,TX,Rural Texas,52,1280000,24615.384615384617,82,2143000,26134.146341463416,-30,-863000
2017,county,48121,Denton,48143,Erath,TX,Rural Texas,51,1275000,25000.0,52,1575000,30288.46153846154,-1,-300000
2017,county,48439,Tarrant,36029,Erie,NY,Buffalo,91,2814000,30923.076923076922,54,1174000,21740.74074074074,37,1640000
2017,county,48113,Dallas,36029,Erie,NY,Buffalo,87,3626000,41678.16091954023,65,2279000,35061.53846153846,22,1347000
2017,county,48121,Denton,36029,Erie,NY,Buffalo,58,1877000,32362.068965517243,43,1739000,40441.86046511628,15,138000
2017,county,48439,Tarrant,12033,Escambia,FL,FL Panhandle,100,2834000,28340.0,120,3021000,25175.0,-20,-187000
2017,county,48113,Dallas,12033,Escambia,FL,FL Panhandle,75,1356000,18080.0,51,1736000,34039.21568627451,24,-380000
2017,county,48113,Dallas,34013,Essex,NJ,New York,137,13633000,99510.94890510949,51,3716000,72862.74509803922,86,9917000
2017,county,48113,Dallas,25009,Essex,MA,Boston,53,1754000,33094.339622641506,49,1898000,38734.69387755102,4,-144000
2017,county,48439,Tarrant,51059,Fairfax,VA,D.C.,288,13116000,45541.666666666664,200,9714000,48570.0,88,3402000
2017,county,48113,Dallas,51059,Fairfax,VA,D.C.,428,25590000,59789.719626168226,316,18510000,58575.94936708861,112,7080000
2017,county,48121,Denton,51059,Fairfax,VA,D.C.,237,11547000,48721.51898734177,83,4762000,57373.49397590361,154,6785000
2017,county,48085,Collin,51059,Fairfax,VA,D.C.,360,18429000,51191.666666666664,183,10111000,55251.366120218576,177,8318000
2017,county,48439,Tarrant,09001,Fairfield,CT,New York,125,11451000,91608.0,59,2931000,49677.96610169492,66,8520000
2017,county,48113,Dallas,09001,Fairfield,CT,New York,217,15268000,70359.4470046083,130,9455000,72730.76923076923,87,5813000
2017,county,48085,Collin,09001,Fairfield,CT,New York,170,7546000,44388.23529411765,66,3982000,60333.333333333336,104,3564000
2017,county,48113,Dallas,48147,Fannin,TX,Rural Texas,75,1301000,17346.666666666668,226,5612000,24831.858407079646,-151,-4311000
2017,county,48121,Denton,48147,Fannin,TX,Rural Texas,62,1399000,22564.516129032258,160,4231000,26443.75,-98,-2832000
2017,county,48085,Collin,48147,Fannin,TX,Rural Texas,295,9341000,31664.406779661018,818,25542000,31224.938875305623,-523,-16201000
2017,county,48439,Tarrant,05045,Faulkner,AR,Little Rock,53,1167000,22018.867924528302,48,1273000,26520.833333333332,5,-106000
2017,county,48113,Dallas,05045,Faulkner,AR,Little Rock,81,2104000,25975.30864197531,43,955000,22209.302325581397,38,1149000
2017,county,48113,Dallas,21067,Fayette,KY,Lexington,54,2111000,39092.59259259259,59,2727000,46220.338983050846,-5,-616000
2017,county,48439,Tarrant,37067,Forsyth,NC,Greensboro,42,2423000,57690.47619047619,42,1567000,37309.52380952381,0,856000
2017,county,48113,Dallas,37067,Forsyth,NC,Greensboro,45,2001000,44466.666666666664,56,2188000,39071.42857142857,-11,-187000
2017,county,48085,Collin,13117,Forsyth,GA,Atlanta,90,4734000,52600.0,110,3984000,36218.181818181816,-20,750000
2017,county,48439,Tarrant,48157,Fort Bend,TX,Houston,473,17892000,37826.638477801265,463,15800000,34125.26997840173,10,2092000
2017,county,48113,Dallas,48157,Fort Bend,TX,Houston,520,25496000,49030.769230769234,462,17047000,36898.268398268396,58,8449000
2017,county,48121,Denton,48157,Fort Bend,TX,Houston,314,15119000,48149.68152866242,331,13493000,40764.35045317221,-17,1626000
2017,county,48085,Collin,48157,Fort Bend,TX,Houston,610,25225000,41352.45901639344,336,15949000,47467.26190476191,274,9276000
2017,county,48439,Tarrant,39049,Franklin,OH,Columbus,184,5915000,32146.739130434784,236,6594000,27940.677966101695,-52,-679000
2017,county,48113,Dallas,39049,Franklin,OH,Columbus,261,10332000,39586.206896551725,311,8339000,26813.504823151125,-50,1993000
2017,county,48121,Denton,39049,Franklin,OH,Columbus,192,7601000,39588.541666666664,70,2632000,37600.0,122,4969000
2017,county,48085,Collin,39049,Franklin,OH,Columbus,215,8991000,41818.604651162794,108,4413000,40861.11111111111,107,4578000
2017,county,48439,Tarrant,48161,Freestone,TX,Rural Texas,42,698000,16619.04761904762,74,3665000,49527.02702702703,-32,-2967000
2017,county,48113,Dallas,48161,Freestone,TX,Rural Texas,54,713000,13203.703703703704,92,1871000,20336.956521739132,-38,-1158000
2017,county,48439,Tarrant,06019,Fresno,CA,Fresno,77,1929000,25051.948051948053,52,862000,16576.923076923078,25,1067000
2017,county,48113,Dallas,06019,Fresno,CA,Fresno,67,2692000,40179.10447761194,91,2844000,31252.747252747253,-24,-152000
2017,county,48439,Tarrant,13121,Fulton,GA,Atlanta,239,16734000,70016.73640167364,233,15876000,68137.33905579399,6,858000
2017,county,48113,Dallas,13121,Fulton,GA,Atlanta,572,38898000,68003.4965034965,514,35224000,68529.18287937743,58,3674000
2017,county,48121,Denton,13121,Fulton,GA,Atlanta,116,5421000,46732.75862068965,128,9055000,70742.1875,-12,-3634000
2017,county,48085,Collin,13121,Fulton,GA,Atlanta,296,15700000,53040.54054054054,199,18753000,94236.18090452261,97,-3053000
2017,county,48439,Tarrant,48167,Galveston,TX,Houston,280,8910000,31821.428571428572,240,7475000,31145.833333333332,40,1435000
2017,county,48113,Dallas,48167,Galveston,TX,Houston,227,7724000,34026.43171806167,288,10298000,35756.944444444445,-61,-2574000
2017,county,48121,Denton,48167,Galveston,TX,Houston,108,4884000,45222.22222222222,169,6995000,41390.5325443787,-61,-2111000
2017,county,48085,Collin,48167,Galveston,TX,Houston,131,5124000,39114.50381679389,147,5499000,37408.163265306124,-16,-375000
2017,county,48439,Tarrant,05051,Garland,AR,Rural Arkansas,58,1862000,32103.44827586207,52,2040000,39230.769230769234,6,-178000
2017,county,48113,Dallas,05051,Garland,AR,Rural Arkansas,50,1075000,21500.0,63,1484000,23555.555555555555,-13,-409000
2017,county,48085,Collin,05051,Garland,AR,Rural Arkansas,42,1138000,27095.238095238095,53,2222000,41924.52830188679,-11,-1084000
2017,county,48439,Tarrant,26049,Genesee,MI,Rural Michigan,107,2095000,19579.439252336448,65,1127000,17338.46153846154,42,968000
2017,county,48113,Dallas,26049,Genesee,MI,Rural Michigan,91,1557000,17109.89010989011,49,759000,15489.795918367347,42,798000
2017,county,48439,Tarrant,48181,Grayson,TX,Rural Texas,305,7236000,23724.590163934427,452,11165000,24701.327433628318,-147,-3929000
2017,county,48113,Dallas,48181,Grayson,TX,Rural Texas,400,10056000,25140.0,742,25548000,34431.266846361184,-342,-15492000
2017,county,48121,Denton,48181,Grayson,TX,Rural Texas,503,12990000,25825.049701789263,1215,35167000,28944.0329218107,-712,-22177000
2017,county,48085,Collin,48181,Grayson,TX,Rural Texas,1020,32101000,31471.56862745098,2800,93638000,33442.142857142855,-1780,-61537000
2017,county,48439,Tarrant,29077,Greene,MO,Rural Missouri,122,3655000,29959.016393442624,66,1498000,22696.969696969696,56,2157000
2017,county,48113,Dallas,29077,Greene,MO,Rural Missouri,62,1774000,28612.90322580645,59,1760000,29830.508474576272,3,14000
2017,county,48085,Collin,29077,Greene,MO,Rural Missouri,79,4177000,52873.417721518985,42,787000,18738.095238095237,37,3390000
2017,county,48439,Tarrant,45045,Greenville,SC,Greenville,73,2719000,37246.57534246575,97,3647000,37597.9381443299,-24,-928000
2017,county,48113,Dallas,45045,Greenville,SC,Greenville,48,1747000,36395.833333333336,57,2324000,40771.929824561405,-9,-577000
2017,county,48085,Collin,45045,Greenville,SC,Greenville,45,2709000,60200.0,62,2460000,39677.41935483871,-17,249000
2017,county,48439,Tarrant,48183,Gregg,TX,Rural Texas,290,6646000,22917.241379310344,267,4453000,16677.902621722846,23,2193000
2017,county,48113,Dallas,48183,Gregg,TX,Rural Texas,416,9781000,23512.01923076923,294,6099000,20744.897959183672,122,3682000
2017,county,48121,Denton,48183,Gregg,TX,Rural Texas,150,3497000,23313.333333333332,103,2943000,28572.81553398058,47,554000
2017,county,48085,Collin,48183,Gregg,TX,Rural Texas,145,4451000,30696.55172413793,108,2739000,25361.11111111111,37,1712000
2017,county,48439,Tarrant,48187,Guadalupe,TX,San Antonio,138,3350000,24275.36231884058,166,4604000,27734.939759036144,-28,-1254000
2017,county,48113,Dallas,48187,Guadalupe,TX,San Antonio,92,2838000,30847.82608695652,84,2547000,30321.428571428572,8,291000
2017,county,48121,Denton,48187,Guadalupe,TX,San Antonio,78,3280000,42051.282051282054,79,2624000,33215.18987341772,-1,656000
2017,county,48085,Collin,48187,Guadalupe,TX,San Antonio,117,2925000,25000.0,65,1748000,26892.30769230769,52,1177000
2017,county,48439,Tarrant,37081,Guilford,NC,Greensboro,117,2733000,23358.97435897436,72,3301000,45847.22222222222,45,-568000
2017,county,48113,Dallas,37081,Guilford,NC,Greensboro,84,3038000,36166.666666666664,72,2081000,28902.777777777777,12,957000
2017,county,48085,Collin,37081,Guilford,NC,Greensboro,80,3918000,48975.0,54,3397000,62907.40740740741,26,521000
2017,county,48439,Tarrant,13135,Gwinnett,GA,Atlanta,208,5746000,27625.0,153,7558000,49398.69281045752,55,-1812000
2017,county,48113,Dallas,13135,Gwinnett,GA,Atlanta,271,7267000,26815.49815498155,199,5693000,28608.040201005024,72,1574000
2017,county,48121,Denton,13135,Gwinnett,GA,Atlanta,163,8967000,55012.26993865031,79,2649000,33531.645569620254,84,6318000
2017,county,48085,Collin,13135,Gwinnett,GA,Atlanta,209,8903000,42598.08612440191,123,4527000,36804.87804878049,86,4376000
2017,county,48439,Tarrant,39061,Hamilton,OH,Cincinnati,120,4379000,36491.666666666664,48,1784000,37166.666666666664,72,2595000
2017,county,48439,Tarrant,18057,Hamilton,IN,Indianapolis,80,4384000,54800.0,70,3206000,45800.0,10,1178000
2017,county,48439,Tarrant,47065,Hamilton,TN,Chattanooga,46,1324000,28782.608695652172,49,1457000,29734.69387755102,-3,-133000
2017,county,48113,Dallas,39061,Hamilton,OH,Cincinnati,135,6766000,50118.51851851852,162,8313000,51314.81481481482,-27,-1547000
2017,county,48113,Dallas,18057,Hamilton,IN,Indianapolis,76,3825000,50328.94736842105,61,2970000,48688.524590163935,15,855000
2017,county,48113,Dallas,47065,Hamilton,TN,Chattanooga,26,1060000,40769.230769230766,76,2224000,29263.157894736843,-50,-1164000
2017,county,48121,Denton,18057,Hamilton,IN,Indianapolis,80,4443000,55537.5,41,1469000,35829.26829268293,39,2974000
2017,county,48085,Collin,39061,Hamilton,OH,Cincinnati,119,7051000,59252.100840336134,38,1600000,42105.26315789474,81,5451000
2017,county,48113,Dallas,51650,Hampton city,VA,Hampton Roads,40,833000,20825.0,40,799000,19975.0,0,34000
2017,county,48439,Tarrant,48201,Harris,TX,Houston,3218,107075000,33273.77252952144,2459,76881000,31265.148434322895,759,30194000
2017,county,48113,Dallas,48201,Harris,TX,Houston,4621,187957000,40674.529322657436,3477,142935000,41108.714408973254,1144,45022000
2017,county,48121,Denton,48201,Harris,TX,Houston,1518,55650000,36660.0790513834,1025,37554000,36638.04878048781,493,18096000
2017,county,48085,Collin,48201,Harris,TX,Houston,1809,73350000,40547.26368159204,1093,47795000,43728.27081427264,716,25555000
2017,county,48439,Tarrant,48203,Harrison,TX,Rural Texas,110,1777000,16154.545454545454,81,1876000,23160.493827160495,29,-99000
2017,county,48439,Tarrant,28047,Harrison,MS,Gulfport-Biloxi,56,1343000,23982.14285714286,44,832000,18909.090909090908,12,511000
2017,county,48113,Dallas,48203,Harrison,TX,Rural Texas,138,3452000,25014.492753623188,161,2579000,16018.633540372672,-23,873000
2017,county,48113,Dallas,28047,Harrison,MS,Gulfport-Biloxi,71,1671000,23535.211267605635,38,1402000,36894.73684210526,33,269000
2017,county,48121,Denton,48203,Harrison,TX,Rural Texas,76,1536000,20210.526315789473,50,1425000,28500.0,26,111000
2017,county,48439,Tarrant,09003,Hartford,CT,Hartford,113,9092000,80460.17699115044,55,1673000,30418.18181818182,58,7419000
2017,county,48113,Dallas,09003,Hartford,CT,Hartford,144,9704000,67388.88888888889,87,4302000,49448.275862068964,57,5402000
2017,county,48085,Collin,09003,Hartford,CT,Hartford,114,5474000,48017.54385964912,52,2114000,40653.846153846156,62,3360000
2017,county,48439,Tarrant,48209,Hays,TX,Austin,226,6435000,28473.451327433628,197,11628000,59025.3807106599,29,-5193000
2017,county,48113,Dallas,48209,Hays,TX,Austin,196,4994000,25479.591836734693,247,8215000,33259.10931174089,-51,-3221000
2017,county,48121,Denton,48209,Hays,TX,Austin,119,3809000,32008.40336134454,147,4656000,31673.469387755104,-28,-847000
2017,county,48085,Collin,48209,Hays,TX,Austin,143,4717000,32986.01398601398,174,7159000,41143.67816091954,-31,-2442000
2017,county,48439,Tarrant,48213,Henderson,TX,Rural Texas,177,5834000,32960.45197740113,377,12072000,32021.220159151195,-200,-6238000
2017,county,48113,Dallas,48213,Henderson,TX,Rural Texas,345,13586000,39379.710144927536,762,25400000,33333.333333333336,-417,-11814000
2017,county,48121,Denton,48213,Henderson,TX,Rural Texas,63,1402000,22253.968253968254,152,9325000,61348.68421052631,-89,-7923000
2017,county,48085,Collin,48213,Henderson,TX,Rural Texas,99,3526000,35616.16161616162,224,10306000,46008.92857142857,-125,-6780000
2017,county,48439,Tarrant,27053,Hennepin,MN,Minneapolis,218,10664000,48917.43119266055,188,8711000,46335.10638297872,30,1953000
2017,county,48113,Dallas,27053,Hennepin,MN,Minneapolis,349,18051000,51722.06303724928,314,22605000,71990.4458598726,35,-4554000
2017,county,48121,Denton,27053,Hennepin,MN,Minneapolis,132,8179000,61962.121212121216,73,3514000,48136.98630136986,59,4665000
2017,county,48085,Collin,27053,Hennepin,MN,Minneapolis,333,15349000,46093.09309309309,151,6573000,43529.801324503314,182,8776000
2017,county,48113,Dallas,51087,Henrico,VA,Richmond,96,3440000,35833.333333333336,56,1707000,30482.14285714286,40,1733000
2017,county,48085,Collin,51087,Henrico,VA,Richmond,138,7463000,54079.710144927536,82,3417000,41670.73170731707,56,4046000
2017,county,48439,Tarrant,48215,Hidalgo,TX,Rural Texas,307,6981000,22739.41368078176,246,5056000,20552.845528455284,61,1925000
2017,county,48113,Dallas,48215,Hidalgo,TX,Rural Texas,487,9466000,19437.371663244354,341,6295000,18460.41055718475,146,3171000
2017,county,48121,Denton,48215,Hidalgo,TX,Rural Texas,113,2679000,23707.964601769912,81,2088000,25777.777777777777,32,591000
2017,county,48085,Collin,48215,Hidalgo,TX,Rural Texas,101,2439000,24148.51485148515,64,1574000,24593.75,37,865000
2017,county,48439,Tarrant,48217,Hill,TX,Rural Texas,172,4222000,24546.511627906977,381,8150000,21391.076115485565,-209,-3928000
2017,county,48113,Dallas,48217,Hill,TX,Rural Texas,100,2198000,21980.0,164,4762000,29036.585365853658,-64,-2564000
2017,county,48439,Tarrant,12057,Hillsborough,FL,Tampa,280,10332000,36900.0,273,8187000,29989.01098901099,7,2145000
2017,county,48439,Tarrant,33011,Hillsborough,NH,Rural New Hampshire,61,1810000,29672.131147540982,56,2798000,49964.28571428572,5,-988000
2017,county,48113,Dallas,12057,Hillsborough,FL,Tampa,402,19502000,48512.437810945274,363,14392000,39647.38292011019,39,5110000
2017,county,48113,Dallas,33011,Hillsborough,NH,Rural New Hampshire,45,2939000,65311.11111111111,56,2993000,53446.42857142857,-11,-54000
2017,county,48121,Denton,12057,Hillsborough,FL,Tampa,189,6045000,31984.126984126986,187,7971000,42625.66844919786,2,-1926000
2017,county,48085,Collin,12057,Hillsborough,FL,Tampa,235,9917000,42200.0,189,10446000,55269.84126984127,46,-529000
2017,county,48439,Tarrant,28049,Hinds,MS,Jackson,247,4079000,16514.17004048583,47,615000,13085.106382978724,200,3464000
2017,county,48113,Dallas,28049,Hinds,MS,Jackson,299,4636000,15505.016722408027,130,3018000,23215.384615384617,169,1618000
2017,county,48439,Tarrant,15003,Honolulu,HI,Rural Hawaii,394,9455000,23997.46192893401,150,7208000,48053.333333333336,244,2247000
2017,county,48113,Dallas,15003,Honolulu,HI,Rural Hawaii,245,11092000,45273.4693877551,137,5113000,37321.16788321168,108,5979000
2017,county,48121,Denton,15003,Honolulu,HI,Rural Hawaii,167,3855000,23083.83233532934,37,1276000,34486.48648648649,130,2579000
2017,county,48085,Collin,15003,Honolulu,HI,Rural Hawaii,151,3820000,25298.01324503311,66,3623000,54893.93939393939,85,197000
2017,county,48439,Tarrant,48221,Hood,TX,Rural Texas,733,18642000,25432.469304229195,1601,58314000,36423.48532167395,-868,-39672000
2017,county,48113,Dallas,48221,Hood,TX,Rural Texas,78,4235000,54294.8717948718,285,10391000,36459.649122807015,-207,-6156000
2017,county,48121,Denton,48221,Hood,TX,Rural Texas,87,2945000,33850.574712643676,172,8624000,50139.53488372093,-85,-5679000
2017,county,48085,Collin,48221,Hood,TX,Rural Texas,61,1520000,24918.032786885247,110,6012000,54654.545454545456,-49,-4492000
2017,county,48439,Tarrant,48223,Hopkins,TX,Rural Texas,51,946000,18549.019607843136,79,1366000,17291.13924050633,-28,-420000
2017,county,48113,Dallas,48223,Hopkins,TX,Rural Texas,116,2313000,19939.655172413793,236,5647000,23927.966101694914,-120,-3334000
2017,county,48121,Denton,48223,Hopkins,TX,Rural Texas,46,1316000,28608.695652173912,42,1122000,26714.285714285714,4,194000
2017,county,48085,Collin,48223,Hopkins,TX,Rural Texas,63,1879000,29825.396825396827,104,3728000,35846.153846153844,-41,-1849000
2017,county,48439,Tarrant,48227,Howard,TX,Rural Texas,91,1799000,19769.23076923077,52,1104000,21230.76923076923,39,695000
2017,county,48113,Dallas,24027,Howard,MD,Baltimore,54,2310000,42777.77777777778,52,1882000,36192.307692307695,2,428000
2017,county,48439,Tarrant,34017,Hudson,NJ,New York,161,4733000,29397.51552795031,40,1900000,47500.0,121,2833000
2017,county,48113,Dallas,34017,Hudson,NJ,New York,305,16639000,54554.098360655735,144,11937000,82895.83333333333,161,4702000
2017,county,48085,Collin,34017,Hudson,NJ,New York,207,8810000,42560.38647342995,53,2277000,42962.264150943396,154,6533000
2017,county,48439,Tarrant,48231,Hunt,TX,Dallas-Fort Worth,218,4499000,20637.61467889908,286,6530000,22832.167832167834,-68,-2031000
2017,county,48113,Dallas,48231,Hunt,TX,Dallas-Fort Worth,933,19152000,20527.33118971061,1961,41662000,21245.283018867925,-1028,-22510000
2017,county,48121,Denton,48231,Hunt,TX,Dallas-Fort Worth,134,2874000,21447.761194029852,344,8684000,25244.18604651163,-210,-5810000
2017,county,48085,Collin,48231,Hunt,TX,Dallas-Fort Worth,567,10914000,19248.67724867725,1220,31895000,26143.44262295082,-653,-20981000
2017,county,48113,Dallas,26065,Ingham,MI,Rural Michigan,57,909000,15947.368421052632,69,1354000,19623.1884057971,-12,-445000
2017,county,48439,Tarrant,53029,Island,WA,Rural Washington,76,1082000,14236.842105263158,46,847000,18413.043478260868,30,235000
2017,county,48439,Tarrant,48237,Jack,TX,Rural Texas,49,1432000,29224.48979591837,75,2046000,27280.0,-26,-614000
2017,county,48439,Tarrant,29095,Jackson,MO,Kansas City,264,5637000,21352.272727272728,191,5977000,31293.193717277485,73,-340000
2017,county,48113,Dallas,29095,Jackson,MO,Kansas City,260,9574000,36823.07692307692,279,8747000,31351.254480286738,-19,827000
2017,county,48121,Denton,29095,Jackson,MO,Kansas City,96,2326000,24229.166666666668,94,4715000,50159.574468085106,2,-2389000
2017,county,48085,Collin,29095,Jackson,MO,Kansas City,122,3473000,28467.213114754097,68,4444000,65352.94117647059,54,-971000
2017,county,48439,Tarrant,48245,Jefferson,TX,Rural Texas,203,4954000,24403.940886699507,111,3468000,31243.243243243243,92,1486000
2017,county,48439,Tarrant,08059,Jefferson,CO,Denver,164,5445000,33201.21951219512,217,7573000,34898.61751152074,-53,-2128000
2017,county,48439,Tarrant,01073,Jefferson,AL,Birmingham,130,4237000,32592.30769230769,82,2162000,26365.853658536584,48,2075000
2017,county,48439,Tarrant,21111,Jefferson,KY,Louisville,122,5509000,45155.737704918036,80,2444000,30550.0,42,3065000
2017,county,48439,Tarrant,05069,Jefferson,AR,Rural Arkansas,91,1132000,12439.560439560439,40,465000,11625.0,51,667000
2017,county,48113,Dallas,48245,Jefferson,TX,Rural Texas,227,5005000,22048.458149779737,93,2090000,22473.11827956989,134,2915000
2017,county,48113,Dallas,21111,Jefferson,KY,Louisville,179,7551000,42184.357541899444,98,3394000,34632.65306122449,81,4157000
2017,county,48113,Dallas,01073,Jefferson,AL,Birmingham,169,5640000,33372.781065088755,104,4651000,44721.153846153844,65,989000
2017,county,48113,Dallas,08059,Jefferson,CO,Denver,108,5158000,47759.25925925926,254,14368000,56566.92913385827,-146,-9210000
2017,county,48113,Dallas,05069,Jefferson,AR,Rural Arkansas,97,1129000,11639.175257731958,46,767000,16673.91304347826,51,362000
2017,county,48121,Denton,08059,Jefferson,CO,Denver,85,4070000,47882.35294117647,146,5370000,36780.82191780822,-61,-1300000
2017,county,48085,Collin,08059,Jefferson,CO,Denver,139,5065000,36438.84892086331,134,8433000,62932.835820895525,5,-3368000
2017,county,48085,Collin,21111,Jefferson,KY,Louisville,107,5166000,48280.3738317757,51,2174000,42627.450980392154,56,2992000
2017,county,48085,Collin,01073,Jefferson,AL,Birmingham,70,2776000,39657.142857142855,47,2045000,43510.63829787234,23,731000
2017,county,48439,Tarrant,22051,Jefferson Parish,LA,New Orleans,158,3491000,22094.936708860758,85,2104000,24752.941176470587,73,1387000
2017,county,48113,Dallas,22051,Jefferson Parish,LA,New Orleans,200,6062000,30310.0,110,3719000,33809.09090909091,90,2343000
2017,county,48121,Denton,22051,Jefferson Parish,LA,New Orleans,81,2272000,28049.382716049382,53,1027000,19377.35849056604,28,1245000
2017,county,48085,Collin,22051,Jefferson Parish,LA,New Orleans,120,3209000,26741.666666666668,48,1861000,38770.833333333336,72,1348000
2017,county,48439,Tarrant,48251,Johnson,TX,Dallas-Fort Worth,4734,122729000,25925.01056189269,8647,217831000,25191.511506881,-3913,-95102000
2017,county,48439,Tarrant,20091,Johnson,KS,Kansas City,219,9470000,43242.00913242009,257,11517000,44813.22957198443,-38,-2047000
2017,county,48113,Dallas,48251,Johnson,TX,Dallas-Fort Worth,487,9778000,20078.028747433265,1007,23491000,23327.70605759682,-520,-13713000
2017,county,48113,Dallas,20091,Johnson,KS,Kansas City,293,13814000,47146.75767918089,248,12006000,48411.290322580644,45,1808000
2017,county,48113,Dallas,19103,Johnson,IA,Rural Iowa,55,1408000,25600.0,51,1977000,38764.705882352944,4,-569000
2017,county,48121,Denton,48251,Johnson,TX,Dallas-Fort Worth,185,6608000,35718.91891891892,297,8809000,29659.93265993266,-112,-2201000
2017,county,48121,Denton,20091,Johnson,KS,Kansas City,158,8627000,54601.26582278481,145,7012000,48358.620689655174,13,1615000
2017,county,48085,Collin,20091,Johnson,KS,Kansas City,310,13502000,43554.83870967742,216,8815000,40810.18518518518,94,4687000
2017,county,48085,Collin,48251,Johnson,TX,Dallas-Fort Worth,141,3995000,28333.333333333332,139,4486000,32273.38129496403,2,-491000
2017,county,48439,Tarrant,17089,Kane,IL,Chicago,161,5661000,35161.490683229815,39,1340000,34358.97435897436,122,4321000
2017,county,48113,Dallas,17089,Kane,IL,Chicago,79,3725000,47151.898734177215,39,1085000,27820.51282051282,40,2640000
2017,county,48439,Tarrant,48257,Kaufman,TX,Dallas-Fort Worth,370,11283000,30494.594594594593,646,17364000,26879.25696594427,-276,-6081000
2017,county,48113,Dallas,48257,Kaufman,TX,Dallas-Fort Worth,2641,60051000,22737.978038621735,7664,175605000,22912.969728601252,-5023,-115554000
2017,county,48121,Denton,48257,Kaufman,TX,Dallas-Fort Worth,246,7067000,28727.642276422765,481,13297000,27644.490644490645,-235,-6230000
2017,county,48085,Collin,48257,Kaufman,TX,Dallas-Fort Worth,502,16407000,32683.266932270915,859,28487000,33162.98020954598,-357,-12080000
2017,county,48439,Tarrant,26081,Kent,MI,Rural Michigan,91,1988000,21846.153846153848,73,2885000,39520.54794520548,18,-897000
2017,county,48113,Dallas,26081,Kent,MI,Rural Michigan,105,2906000,27676.190476190477,88,3997000,45420.454545454544,17,-1091000
2017,county,48085,Collin,26081,Kent,MI,Rural Michigan,45,1057000,23488.88888888889,39,1179000,30230.76923076923,6,-122000
2017,county,48439,Tarrant,06029,Kern,CA,Rural California,202,6011000,29757.425742574258,73,1876000,25698.630136986303,129,4135000
2017,county,48113,Dallas,06029,Kern,CA,Rural California,122,2927000,23991.803278688523,64,1808000,28250.0,58,1119000
2017,county,48439,Tarrant,48265,Kerr,TX,Rural Texas,50,1033000,20660.0,65,2893000,44507.692307692305,-15,-1860000
2017,county,48113,Dallas,48265,Kerr,TX,Rural Texas,35,840000,24000.0,47,1872000,39829.78723404255,-12,-1032000
2017,county,48439,Tarrant,53033,King,WA,Seattle,449,18125000,40367.48329621381,445,19280000,43325.84269662921,4,-1155000
2017,county,48113,Dallas,53033,King,WA,Seattle,575,35845000,62339.13043478261,785,48849000,62228.02547770701,-210,-13004000
2017,county,48121,Denton,53033,King,WA,Seattle,275,14593000,53065.454545454544,266,15123000,56853.38345864662,9,-530000
2017,county,48085,Collin,53033,King,WA,Seattle,509,25542000,50180.74656188605,617,33924000,54982.17179902755,-108,-8382000
2017,county,48439,Tarrant,36047,Kings,NY,New York,176,3813000,21664.772727272728,79,2253000,28518.98734177215,97,1560000
2017,county,48113,Dallas,36047,Kings,NY,New York,341,16240000,47624.63343108504,211,13187000,62497.63033175356,130,3053000
2017,county,48121,Denton,36047,Kings,NY,New York,81,3261000,40259.25925925926,59,1394000,23627.118644067796,22,1867000
2017,county,48085,Collin,36047,Kings,NY,New York,157,5500000,35031.84713375796,55,2228000,40509.09090909091,102,3272000
2017,county,48439,Tarrant,53035,Kitsap,WA,Rural Washington,76,1582000,20815.78947368421,42,986000,23476.190476190477,34,596000
2017,county,48439,Tarrant,47093,Knox,TN,Knoxville,72,1975000,27430.555555555555,68,3490000,51323.529411764706,4,-1515000
2017,county,48113,Dallas,47093,Knox,TN,Knoxville,72,2820000,39166.666666666664,45,2534000,56311.11111111111,27,286000
2017,county,48085,Collin,47093,Knox,TN,Knoxville,71,2666000,37549.295774647886,67,3084000,46029.850746268654,4,-418000
2017,county,48439,Tarrant,22055,Lafayette Parish,LA,Rural Louisiana,116,3198000,27568.96551724138,49,2637000,53816.32653061225,67,561000
2017,county,48113,Dallas,22055,Lafayette Parish,LA,Rural Louisiana,129,3059000,23713.178294573645,69,1660000,24057.971014492752,60,1399000
2017,county,48439,Tarrant,18089,Lake,IN,Rural Indiana,176,3400000,19318.18181818182,42,863000,20547.619047619046,134,2537000
2017,county,48439,Tarrant,17097,Lake,IL,Chicago,152,15318000,100776.31578947368,102,4585000,44950.98039215686,50,10733000
2017,county,48113,Dallas,17097,Lake,IL,Chicago,176,15005000,85255.68181818182,142,6066000,42718.30985915493,34,8939000
2017,county,48113,Dallas,18089,Lake,IN,Rural Indiana,96,2177000,22677.083333333332,37,757000,20459.45945945946,59,1420000
2017,county,48113,Dallas,12069,Lake,FL,Orlando,53,1344000,25358.490566037737,44,1829000,41568.181818181816,9,-485000
2017,county,48121,Denton,17097,Lake,IL,Chicago,141,8453000,59950.354609929076,54,3489000,64611.11111111111,87,4964000
2017,county,48085,Collin,17097,Lake,IL,Chicago,199,9792000,49206.030150753766,70,5168000,73828.57142857143,129,4624000
2017,county,48439,Tarrant,48277,Lamar,TX,Rural Texas,90,2095000,23277.777777777777,73,1722000,23589.04109589041,17,373000
2017,county,48113,Dallas,48277,Lamar,TX,Rural Texas,148,2669000,18033.783783783783,190,3915000,20605.263157894737,-42,-1246000
2017,county,48121,Denton,48277,Lamar,TX,Rural Texas,81,1871000,23098.765432098764,81,2099000,25913.58024691358,0,-228000
2017,county,48085,Collin,48277,Lamar,TX,Rural Texas,72,2134000,29638.88888888889,115,3465000,30130.434782608696,-43,-1331000
2017,county,48113,Dallas,31109,Lancaster,NE,Rural Nebraska,68,1692000,24882.352941176472,76,1519000,19986.842105263157,-8,173000
2017,county,48439,Tarrant,08069,Larimer,CO,Rural Colorado,102,3408000,33411.76470588235,139,6472000,46561.15107913669,-37,-3064000
2017,county,48113,Dallas,08069,Larimer,CO,Rural Colorado,71,1942000,27352.11267605634,86,4608000,53581.395348837206,-15,-2666000
2017,county,48121,Denton,08069,Larimer,CO,Rural Colorado,61,2692000,44131.147540983606,74,3082000,41648.64864864865,-13,-390000
2017,county,48085,Collin,08069,Larimer,CO,Rural Colorado,33,1655000,50151.51515151515,80,3324000,41550.0,-47,-1669000
2017,county,48439,Tarrant,12071,Lee,FL,S.W. Florida,67,3604000,53791.0447761194,112,4328000,38642.857142857145,-45,-724000
2017,county,48113,Dallas,12071,Lee,FL,S.W. Florida,112,3356000,29964.285714285714,61,3990000,65409.83606557377,51,-634000
2017,county,48121,Denton,12071,Lee,FL,S.W. Florida,57,2356000,41333.333333333336,88,3054000,34704.545454545456,-31,-698000
2017,county,48085,Collin,12071,Lee,FL,S.W. Florida,91,3133000,34428.57142857143,75,7107000,94760.0,16,-3974000
2017,county,48439,Tarrant,12073,Leon,FL,Rural Florida,37,956000,25837.837837837837,49,1071000,21857.14285714286,-12,-115000
2017,county,48439,Tarrant,48293,Limestone,TX,Rural Texas,75,1315000,17533.333333333332,36,646000,17944.444444444445,39,669000
2017,county,48113,Dallas,48293,Limestone,TX,Rural Texas,65,497000,7646.153846153846,53,1096000,20679.245283018867,12,-599000
2017,county,48439,Tarrant,06037,Los Angeles,CA,Los Angeles,1723,59300000,34416.71503192107,875,31439000,35930.28571428572,848,27861000
2017,county,48113,Dallas,06037,Los Angeles,CA,Los Angeles,2357,122501000,51973.27110733984,1357,67872000,50016.212232866616,1000,54629000
2017,county,48121,Denton,06037,Los Angeles,CA,Los Angeles,1662,90022000,54164.861612515044,340,10755000,31632.352941176472,1322,79267000
2017,county,48085,Collin,06037,Los Angeles,CA,Los Angeles,3105,166155000,53512.07729468599,518,24044000,46416.98841698842,2587,142111000
2017,county,48439,Tarrant,51107,Loudoun,VA,Rural Virginia,99,4906000,49555.555555555555,66,5174000,78393.93939393939,33,-268000
2017,county,48113,Dallas,51107,Loudoun,VA,Rural Virginia,109,5268000,48330.2752293578,89,6917000,77719.10112359551,20,-1649000
2017,county,48085,Collin,51107,Loudoun,VA,Rural Virginia,209,10015000,47918.66028708134,142,6828000,48084.50704225352,67,3187000
2017,county,48439,Tarrant,48303,Lubbock,TX,Rural Texas,869,21421000,24650.17261219793,482,13564000,28141.078838174275,387,7857000
2017,county,48113,Dallas,48303,Lubbock,TX,Rural Texas,635,17708000,27886.614173228347,436,11226000,25747.70642201835,199,6482000
2017,county,48121,Denton,48303,Lubbock,TX,Rural Texas,378,12182000,32227.513227513227,185,7337000,39659.45945945946,193,4845000
2017,county,48085,Collin,48303,Lubbock,TX,Rural Texas,392,13376000,34122.448979591834,250,6857000,27428.0,142,6519000
2017,county,48439,Tarrant,39095,Lucas,OH,Rural Ohio,74,1805000,24391.891891891893,47,1253000,26659.574468085106,27,552000
2017,county,48439,Tarrant,26099,Macomb,MI,Rural Michigan,106,2584000,24377.35849056604,83,1821000,21939.75903614458,23,763000
2017,county,48113,Dallas,26099,Macomb,MI,Rural Michigan,89,2703000,30370.786516853932,37,981000,26513.513513513513,52,1722000
2017,county,48085,Collin,26099,Macomb,MI,Rural Michigan,89,2710000,30449.43820224719,47,1373000,29212.76595744681,42,1337000
2017,county,48439,Tarrant,01089,Madison,AL,Huntsville,106,3119000,29424.528301886792,78,2553000,32730.76923076923,28,566000
2017,county,48113,Dallas,28089,Madison,MS,Jackson,78,2020000,25897.4358974359,34,948000,27882.352941176472,44,1072000
2017,county,48113,Dallas,01089,Madison,AL,Huntsville,66,2148000,32545.454545454544,47,1286000,27361.702127659573,19,862000
2017,county,48439,Tarrant,12081,Manatee,FL,Rural Florida,42,2025000,48214.28571428572,76,3975000,52302.63157894737,-34,-1950000
2017,county,48113,Dallas,12081,Manatee,FL,Rural Florida,38,1867000,49131.57894736842,42,1691000,40261.90476190476,-4,176000
2017,county,48121,Denton,12081,Manatee,FL,Rural Florida,59,3881000,65779.66101694915,39,3012000,77230.76923076923,20,869000
2017,county,48085,Collin,12081,Manatee,FL,Rural Florida,60,2242000,37366.666666666664,99,7296000,73696.9696969697,-39,-5054000
2017,county,48439,Tarrant,04013,Maricopa,AZ,Phoenix,1063,46364000,43616.18062088429,1017,36712000,36098.32841691249,46,9652000
2017,county,48113,Dallas,04013,Maricopa,AZ,Phoenix,1055,54616000,51768.72037914692,973,47982000,49313.46351490237,82,6634000
2017,county,48121,Denton,04013,Maricopa,AZ,Phoenix,618,31265000,50590.61488673139,542,26946000,49715.86715867159,76,4319000
2017,county,48085,Collin,04013,Maricopa,AZ,Phoenix,869,39291000,45214.03912543153,666,29920000,44924.924924924926,203,9371000
2017,county,48113,Dallas,06041,Marin,CA,Bay Area,29,1426000,49172.41379310345,53,4707000,88811.32075471699,-24,-3281000
2017,county,48439,Tarrant,18097,Marion,IN,Indianapolis,241,5652000,23452.28215767635,104,2168000,20846.153846153848,137,3484000
2017,county,48439,Tarrant,12083,Marion,FL,Rural Florida,36,1262000,35055.555555555555,54,1743000,32277.777777777777,-18,-481000
2017,county,48113,Dallas,18097,Marion,IN,Indianapolis,251,8127000,32378.48605577689,153,4702000,30732.02614379085,98,3425000
2017,county,48121,Denton,18097,Marion,IN,Indianapolis,69,2492000,36115.942028985504,107,2064000,19289.719626168226,-38,428000
2017,county,48085,Collin,18097,Marion,IN,Indianapolis,92,3163000,34380.434782608696,40,1414000,35350.0,52,1749000
2017,county,48439,Tarrant,48323,Maverick,TX,Rural Texas,46,507000,11021.739130434782,62,797000,12854.838709677419,-16,-290000
2017,county,48439,Tarrant,17111,McHenry,IL,Chicago,74,3589000,48500.0,57,1401000,24578.947368421053,17,2188000
2017,county,48113,Dallas,17113,McLean,IL,Rural Illinois,150,6587000,43913.333333333336,50,1980000,39600.0,100,4607000
2017,county,48085,Collin,17113,McLean,IL,Rural Illinois,456,22488000,49315.78947368421,51,2476000,48549.01960784314,405,20012000
2017,county,48439,Tarrant,48309,McLennan,TX,Rural Texas,680,16767000,24657.352941176472,541,12269000,22678.37338262477,139,4498000
2017,county,48113,Dallas,48309,McLennan,TX,Rural Texas,629,16056000,25526.23211446741,619,18340000,29628.43295638126,10,-2284000
2017,county,48121,Denton,48309,McLennan,TX,Rural Texas,192,4923000,25640.625,260,7932000,30507.69230769231,-68,-3009000
2017,county,48085,Collin,48309,McLennan,TX,Rural Texas,198,6821000,34449.49494949495,254,7226000,28448.818897637797,-56,-405000
2017,county,48439,Tarrant,37119,Mecklenburg,NC,Charlotte,230,9074000,39452.17391304348,183,13347000,72934.4262295082,47,-4273000
2017,county,48113,Dallas,37119,Mecklenburg,NC,Charlotte,423,24092000,56955.08274231679,384,18143000,47247.395833333336,39,5949000
2017,county,48121,Denton,37119,Mecklenburg,NC,Charlotte,140,6682000,47728.57142857143,119,6579000,55285.71428571428,21,103000
2017,county,48085,Collin,37119,Mecklenburg,NC,Charlotte,293,11920000,40682.59385665529,172,9560000,55581.395348837206,121,2360000
2017,county,48113,Dallas,34021,Mercer,NJ,Rural New Jersey,68,3750000,55147.05882352941,41,1570000,38292.68292682927,27,2180000
2017,county,48439,Tarrant,12086,Miami-Dade,FL,Miami,348,8857000,25451.149425287356,209,5133000,24559.808612440193,139,3724000
2017,county,48113,Dallas,12086,Miami-Dade,FL,Miami,536,16810000,31361.940298507463,339,21635000,63820.058997050146,197,-4825000
2017,county,48121,Denton,12086,Miami-Dade,FL,Miami,173,4707000,27208.092485549132,78,2083000,26705.128205128207,95,2624000
2017,county,48085,Collin,12086,Miami-Dade,FL,Miami,256,15952000,62312.5,86,3414000,39697.67441860465,170,12538000
2017,county,48439,Tarrant,25017,Middlesex,MA,Boston,137,5377000,39248.175182481755,129,6968000,54015.50387596899,8,-1591000
2017,county,48439,Tarrant,34023,Middlesex,NJ,New York,155,5392000,34787.096774193546,42,1697000,40404.76190476191,113,3695000
2017,county,48113,Dallas,25017,Middlesex,MA,Boston,302,15604000,51668.87417218543,220,16318000,74172.72727272728,82,-714000
2017,county,48113,Dallas,34023,Middlesex,NJ,New York,357,11904000,33344.53781512605,141,4881000,34617.02127659575,216,7023000
2017,county,48121,Denton,25017,Middlesex,MA,Boston,89,5047000,56707.86516853933,81,3702000,45703.7037037037,8,1345000
2017,county,48085,Collin,34023,Middlesex,NJ,New York,503,20832000,41415.506958250495,117,4201000,35905.982905982906,386,16631000
2017,county,48085,Collin,25017,Middlesex,MA,Boston,218,11645000,53417.43119266055,141,6113000,43354.60992907801,77,5532000
2017,county,48439,Tarrant,48329,Midland,TX,Rural Texas,645,25589000,39672.86821705427,367,12535000,34155.31335149864,278,13054000
2017,county,48113,Dallas,48329,Midland,TX,Rural Texas,432,24514000,56745.37037037037,259,8384000,32370.656370656372,173,16130000
2017,county,48121,Denton,48329,Midland,TX,Rural Texas,215,8182000,38055.813953488374,130,6139000,47223.07692307692,85,2043000
2017,county,48085,Collin,48329,Midland,TX,Rural Texas,210,12099000,57614.28571428572,93,3866000,41569.89247311828,117,8233000
2017,county,48113,Dallas,05091,Miller,AR,Rural Arkansas,69,1296000,18782.608695652172,49,438000,8938.775510204081,20,858000
2017,county,48439,Tarrant,55079,Milwaukee,WI,Milwaukee,302,5477000,18135.761589403974,104,1722000,16557.69230769231,198,3755000
2017,county,48113,Dallas,55079,Milwaukee,WI,Milwaukee,339,8999000,26545.722713864307,124,4331000,34927.41935483871,215,4668000
2017,county,48121,Denton,55079,Milwaukee,WI,Milwaukee,121,3214000,26561.98347107438,31,612000,19741.935483870966,90,2602000
2017,county,48085,Collin,55079,Milwaukee,WI,Milwaukee,255,7405000,29039.21568627451,44,993000,22568.18181818182,211,6412000
2017,county,48439,Tarrant,01097,Mobile,AL,Mobile,66,1691000,25621.21212121212,51,1296000,25411.764705882353,15,395000
2017,county,48113,Dallas,01097,Mobile,AL,Mobile,87,1627000,18701.149425287356,49,1972000,40244.897959183676,38,-345000
2017,county,48113,Dallas,36055,Monroe,NY,Rochester,71,2180000,30704.225352112677,49,1226000,25020.408163265307,22,954000
2017,county,48439,Tarrant,48337,Montague,TX,Rural Texas,95,1892000,19915.78947368421,240,6756000,28150.0,-145,-4864000
2017,county,48121,Denton,48337,Montague,TX,Rural Texas,82,2698000,32902.439024390245,202,5582000,27633.663366336634,-120,-2884000
2017,county,48113,Dallas,06053,Monterey,CA,Rural California,52,1257000,24173.076923076922,44,2466000,56045.454545454544,8,-1209000
2017,county,48439,Tarrant,48339,Montgomery,TX,Houston,498,24508000,49212.85140562249,655,27293000,41668.70229007633,-157,-2785000
2017,county,48439,Tarrant,24031,Montgomery,MD,D.C.,150,8747000,58313.333333333336,118,4350000,36864.40677966102,32,4397000
2017,county,48439,Tarrant,39113,Montgomery,OH,Rural Ohio,74,1832000,24756.756756756757,51,1171000,22960.78431372549,23,661000
2017,county,48439,Tarrant,47125,Montgomery,TN,Rural Tennessee,93,2292000,24645.16129032258,65,1458000,22430.76923076923,28,834000
2017,county,48113,Dallas,48339,Montgomery,TX,Houston,442,20027000,45309.95475113122,421,15933000,37845.605700712586,21,4094000
2017,county,48113,Dallas,24031,Montgomery,MD,D.C.,263,11356000,43178.7072243346,197,8079000,41010.15228426396,66,3277000
2017,county,48113,Dallas,42091,Montgomery,PA,Philadelphia,138,7597000,55050.72463768116,116,5226000,45051.724137931036,22,2371000
2017,county,48113,Dallas,39113,Montgomery,OH,Rural Ohio,78,2057000,26371.79487179487,51,1144000,22431.37254901961,27,913000
2017,county,48113,Dallas,47125,Montgomery,TN,Rural Tennessee,60,820000,13666.666666666666,36,619000,17194.444444444445,24,201000
2017,county,48121,Denton,48339,Montgomery,TX,Houston,298,14725000,49412.75167785235,313,14062000,44926.517571884986,-15,663000
2017,county,48121,Denton,24031,Montgomery,MD,D.C.,76,3050000,40131.57894736842,45,1754000,38977.77777777778,31,1296000
2017,county,48085,Collin,48339,Montgomery,TX,Houston,346,14489000,41875.722543352604,334,13069000,39128.74251497006,12,1420000
2017,county,48085,Collin,24031,Montgomery,MD,D.C.,197,7664000,38903.553299492385,87,3306000,38000.0,110,4358000
2017,county,48085,Collin,42091,Montgomery,PA,Philadelphia,146,5131000,35143.83561643836,51,3013000,59078.43137254902,95,2118000
2017,county,48439,Tarrant,34027,Morris,NJ,New York,51,7530000,147647.0588235294,58,5415000,93362.06896551725,-7,2115000
2017,county,48113,Dallas,34027,Morris,NJ,New York,146,8833000,60500.0,62,3689000,59500.0,84,5144000
2017,county,48085,Collin,34027,Morris,NJ,New York,102,7064000,69254.90196078431,69,2875000,41666.666666666664,33,4189000
2017,county,48439,Tarrant,41051,Multnomah,OR,Portland,91,2315000,25439.56043956044,74,2389000,32283.783783783783,17,-74000
2017,county,48113,Dallas,41051,Multnomah,OR,Portland,98,4977000,50785.71428571428,200,12880000,64400.0,-102,-7903000
2017,county,48085,Collin,41051,Multnomah,OR,Portland,49,2937000,59938.77551020408,45,2230000,49555.555555555555,4,707000
2017,county,48113,Dallas,13215,Muscogee,GA,Columbus,41,932000,22731.70731707317,34,747000,21970.58823529412,7,185000
2017,county,48113,Dallas,40101,Muskogee,OK,Rural Oklahoma,41,655000,15975.609756097561,44,1189000,27022.727272727272,-3,-534000
2017,county,48439,Tarrant,48347,Nacogdoches,TX,Rural Texas,134,2055000,15335.820895522387,95,1868000,19663.157894736843,39,187000
2017,county,48113,Dallas,48347,Nacogdoches,TX,Rural Texas,193,3359000,17404.145077720208,91,2231000,24516.483516483517,102,1128000
2017,county,48439,Tarrant,36059,Nassau,NY,New York,113,3569000,31584.070796460175,45,1350000,30000.0,68,2219000
2017,county,48113,Dallas,36059,Nassau,NY,New York,210,6958000,33133.333333333336,64,2881000,45015.625,146,4077000
2017,county,48439,Tarrant,48349,Navarro,TX,Rural Texas,146,2823000,19335.616438356163,254,6871000,27051.181102362203,-108,-4048000
2017,county,48113,Dallas,48349,Navarro,TX,Rural Texas,360,6040000,16777.777777777777,563,10012000,17783.30373001776,-203,-3972000
2017,county,48085,Collin,48349,Navarro,TX,Rural Texas,36,937000,26027.777777777777,71,4306000,60647.887323943665,-35,-3369000
2017,county,48439,Tarrant,10003,New Castle,DE,Rural Delaware,68,1657000,24367.647058823528,47,1592000,33872.34042553192,21,65000
2017,county,48113,Dallas,10003,New Castle,DE,Rural Delaware,100,4433000,44330.0,85,3829000,45047.05882352941,15,604000
2017,county,48085,Collin,10003,New Castle,DE,Rural Delaware,144,6339000,44020.833333333336,51,2149000,42137.25490196078,93,4190000
2017,county,48113,Dallas,09009,New Haven,CT,New Haven,84,2800000,33333.333333333336,73,4254000,58273.97260273973,11,-1454000
2017,county,48439,Tarrant,36061,New York,NY,New York,161,10871000,67521.73913043478,113,5136000,45451.32743362832,48,5735000
2017,county,48113,Dallas,36061,New York,NY,New York,588,74721000,127076.5306122449,532,44791000,84193.6090225564,56,29930000
2017,county,48121,Denton,36061,New York,NY,New York,72,10415000,144652.77777777778,49,3605000,73571.42857142857,23,6810000
2017,county,48085,Collin,36061,New York,NY,New York,142,8137000,57302.81690140845,114,9334000,81877.19298245614,28,-1197000
2017,county,48439,Tarrant,51700,Newport News city,VA,Hampton Roads,60,1295000,21583.333333333332,43,931000,21651.162790697676,17,364000
2017,county,48439,Tarrant,25021,Norfolk,MA,Boston,69,7301000,105811.59420289854,53,3937000,74283.01886792453,16,3364000
2017,county,48113,Dallas,25021,Norfolk,MA,Boston,116,5114000,44086.206896551725,83,4951000,59650.60240963855,33,163000
2017,county,48085,Collin,25021,Norfolk,MA,Boston,84,3284000,39095.23809523809,47,2703000,57510.63829787234,37,581000
2017,county,48439,Tarrant,51710,Norfolk city,VA,Hampton Roads,63,1137000,18047.619047619046,69,1371000,19869.565217391304,-6,-234000
2017,county,48113,Dallas,51710,Norfolk city,VA,Hampton Roads,74,1781000,24067.567567567567,48,1292000,26916.666666666668,26,489000
2017,county,48439,Tarrant,48355,Nueces,TX,Rural Texas,346,8403000,24286.127167630057,272,7212000,26514.70588235294,74,1191000
2017,county,48113,Dallas,48355,Nueces,TX,Rural Texas,362,11530000,31850.82872928177,217,5853000,26972.350230414748,145,5677000
2017,county,48121,Denton,48355,Nueces,TX,Rural Texas,108,3583000,33175.92592592593,108,4314000,39944.444444444445,0,-731000
2017,county,48085,Collin,48355,Nueces,TX,Rural Texas,184,6552000,35608.69565217391,88,2824000,32090.909090909092,96,3728000
2017,county,48439,Tarrant,26125,Oakland,MI,Detroit,280,11552000,41257.142857142855,153,6580000,43006.535947712415,127,4972000
2017,county,48113,Dallas,26125,Oakland,MI,Detroit,295,15601000,52884.745762711864,174,10189000,58557.471264367814,121,5412000
2017,county,48121,Denton,26125,Oakland,MI,Detroit,161,7285000,45248.44720496894,82,3175000,38719.51219512195,79,4110000
2017,county,48085,Collin,26125,Oakland,MI,Detroit,270,11761000,43559.25925925926,138,5784000,41913.04347826087,132,5977000
2017,county,48439,Tarrant,12091,Okaloosa,FL,FL Panhandle,100,3521000,35210.0,124,4079000,32895.16129032258,-24,-558000
2017,county,48113,Dallas,12091,Okaloosa,FL,FL Panhandle,42,2188000,52095.23809523809,50,2962000,59240.0,-8,-774000
2017,county,48439,Tarrant,40109,Oklahoma,OK,Oklahoma City,788,27206000,34525.3807106599,630,19334000,30688.88888888889,158,7872000
2017,county,48113,Dallas,40109,Oklahoma,OK,Oklahoma City,884,44910000,50803.16742081448,700,26093000,37275.71428571428,184,18817000
2017,county,48121,Denton,40109,Oklahoma,OK,Oklahoma City,399,9847000,24679.19799498747,247,7941000,32149.7975708502,152,1906000
2017,county,48085,Collin,40109,Oklahoma,OK,Oklahoma City,484,17826000,36830.57851239669,295,11019000,37352.542372881355,189,6807000
2017,county,48113,Dallas,36067,Onondaga,NY,Rural New York,58,1593000,27465.51724137931,40,1830000,45750.0,18,-237000
2017,county,48439,Tarrant,37133,Onslow,NC,Rural North Carolina,203,2982000,14689.655172413793,86,1686000,19604.6511627907,117,1296000
2017,county,48113,Dallas,37133,Onslow,NC,Rural North Carolina,95,1810000,19052.63157894737,37,885000,23918.91891891892,58,925000
2017,county,48439,Tarrant,06059,Orange,CA,Los Angeles,838,37058000,44221.95704057279,392,18560000,47346.93877551021,446,18498000
2017,county,48439,Tarrant,12095,Orange,FL,Orlando,311,11007000,35392.28295819936,322,14002000,43484.472049689444,-11,-2995000
2017,county,48439,Tarrant,36071,Orange,NY,Rural New York,74,1773000,23959.45945945946,58,1271000,21913.793103448275,16,502000
2017,county,48113,Dallas,06059,Orange,CA,Los Angeles,828,69297000,83692.02898550725,526,30232000,57475.28517110266,302,39065000
2017,county,48113,Dallas,12095,Orange,FL,Orlando,338,12218000,36147.92899408284,291,13053000,44855.67010309279,47,-835000
2017,county,48113,Dallas,37135,Orange,NC,Raleigh,37,3896000,105297.2972972973,48,2786000,58041.666666666664,-11,1110000
2017,county,48121,Denton,06059,Orange,CA,Los Angeles,820,48094000,58651.21951219512,250,14853000,59412.0,570,33241000
2017,county,48121,Denton,12095,Orange,FL,Orlando,138,4448000,32231.884057971016,120,5444000,45366.666666666664,18,-996000
2017,county,48085,Collin,06059,Orange,CA,Los Angeles,1390,73026000,52536.69064748201,395,19259000,48756.962025316454,995,53767000
2017,county,48085,Collin,12095,Orange,FL,Orlando,263,10537000,40064.63878326996,191,7375000,38612.56544502618,72,3162000
2017,county,48439,Tarrant,22071,Orleans Parish,LA,New Orleans,164,4762000,29036.585365853658,138,2508000,18173.91304347826,26,2254000
2017,county,48113,Dallas,22071,Orleans Parish,LA,New Orleans,286,8333000,29136.363636363636,204,6497000,31848.039215686276,82,1836000
2017,county,48121,Denton,22071,Orleans Parish,LA,New Orleans,59,1051000,17813.5593220339,72,2650000,36805.555555555555,-13,-1599000
2017,county,48085,Collin,22071,Orleans Parish,LA,New Orleans,82,2939000,35841.46341463415,63,1504000,23873.015873015873,19,1435000
2017,county,48439,Tarrant,12097,Osceola,FL,Orlando,61,903000,14803.27868852459,92,1969000,21402.17391304348,-31,-1066000
2017,county,48113,Dallas,12097,Osceola,FL,Orlando,35,1001000,28600.0,53,1721000,32471.69811320755,-18,-720000
2017,county,48085,Collin,12097,Osceola,FL,Orlando,62,1093000,17629.032258064515,43,1204000,28000.0,19,-111000
2017,county,48439,Tarrant,22073,Ouachita Parish,LA,Rural Louisiana,235,3358000,14289.36170212766,101,993000,9831.683168316831,134,2365000
2017,county,48113,Dallas,22073,Ouachita Parish,LA,Rural Louisiana,384,5420000,14114.583333333334,134,1776000,13253.731343283582,250,3644000
2017,county,48085,Collin,22073,Ouachita Parish,LA,Rural Louisiana,107,2717000,25392.52336448598,48,1346000,28041.666666666668,59,1371000
2017,county,48439,Tarrant,12099,Palm Beach,FL,Miami,260,7669000,29496.153846153848,142,7806000,54971.83098591549,118,-137000
2017,county,48113,Dallas,12099,Palm Beach,FL,Miami,284,10726000,37767.605633802814,217,22344000,102967.74193548386,67,-11618000
2017,county,48121,Denton,12099,Palm Beach,FL,Miami,142,8040000,56619.718309859156,85,3671000,43188.23529411765,57,4369000
2017,county,48085,Collin,12099,Palm Beach,FL,Miami,149,4917000,33000.0,110,6507000,59154.545454545456,39,-1590000
2017,county,48439,Tarrant,48363,Palo Pinto,TX,Rural Texas,221,5096000,23058.823529411766,327,9317000,28492.35474006116,-106,-4221000
2017,county,48121,Denton,48363,Palo Pinto,TX,Rural Texas,43,967000,22488.372093023256,53,3152000,59471.698113207545,-10,-2185000
2017,county,48439,Tarrant,48367,Parker,TX,Dallas-Fort Worth,3434,116301000,33867.50145602795,7760,262021000,33765.592783505155,-4326,-145720000
2017,county,48113,Dallas,48367,Parker,TX,Dallas-Fort Worth,191,6498000,34020.94240837696,349,12505000,35830.94555873926,-158,-6007000
2017,county,48121,Denton,48367,Parker,TX,Dallas-Fort Worth,280,8585000,30660.714285714286,493,15216000,30864.097363083165,-213,-6631000
2017,county,48085,Collin,48367,Parker,TX,Dallas-Fort Worth,114,3743000,32833.333333333336,194,8007000,41273.19587628866,-80,-4264000
2017,county,48439,Tarrant,12101,Pasco,FL,Tampa,96,1749000,18218.75,103,3841000,37291.26213592233,-7,-2092000
2017,county,48113,Dallas,12101,Pasco,FL,Tampa,52,1101000,21173.076923076922,60,4597000,76616.66666666667,-8,-3496000
2017,county,48085,Collin,12101,Pasco,FL,Tampa,93,2974000,31978.494623655915,73,2547000,34890.41095890411,20,427000
2017,county,48439,Tarrant,40119,Payne,OK,Rural Oklahoma,53,1398000,26377.35849056604,44,906000,20590.909090909092,9,492000
2017,county,48121,Denton,40119,Payne,OK,Rural Oklahoma,28,783000,27964.285714285714,38,1295000,34078.94736842105,-10,-512000
2017,county,48439,Tarrant,42101,Philadelphia,PA,Philadelphia,121,3274000,27057.85123966942,56,2369000,42303.57142857143,65,905000
2017,county,48113,Dallas,42101,Philadelphia,PA,Philadelphia,210,10149000,48328.57142857143,147,8638000,58761.90476190476,63,1511000
2017,county,48085,Collin,42101,Philadelphia,PA,Philadelphia,68,2532000,37235.294117647056,42,2056000,48952.380952380954,26,476000
2017,county,48439,Tarrant,53053,Pierce,WA,Seattle,199,4807000,24155.77889447236,209,4896000,23425.837320574163,-10,-89000
2017,county,48113,Dallas,53053,Pierce,WA,Seattle,165,4590000,27818.18181818182,170,4685000,27558.823529411766,-5,-95000
2017,county,48121,Denton,53053,Pierce,WA,Seattle,105,3216000,30628.571428571428,74,2435000,32905.40540540541,31,781000
2017,county,48085,Collin,53053,Pierce,WA,Seattle,120,3536000,29466.666666666668,111,3598000,32414.414414414416,9,-62000
2017,county,48439,Tarrant,04019,Pima,AZ,Tucson,237,8509000,35902.95358649789,216,5758000,26657.40740740741,21,2751000
2017,county,48113,Dallas,04019,Pima,AZ,Tucson,213,5777000,27122.06572769953,178,10472000,58831.4606741573,35,-4695000
2017,county,48121,Denton,04019,Pima,AZ,Tucson,118,3695000,31313.5593220339,75,2703000,36040.0,43,992000
2017,county,48085,Collin,04019,Pima,AZ,Tucson,225,10174000,45217.77777777778,129,12387000,96023.25581395348,96,-2213000
2017,county,48439,Tarrant,04021,Pinal,AZ,Phoenix,74,1831000,24743.243243243243,102,4705000,46127.450980392154,-28,-2874000
2017,county,48439,Tarrant,12103,Pinellas,FL,Tampa,173,6171000,35670.52023121387,180,8418000,46766.666666666664,-7,-2247000
2017,county,48113,Dallas,12103,Pinellas,FL,Tampa,158,6375000,40348.101265822785,174,11271000,64775.862068965514,-16,-4896000
2017,county,48121,Denton,12103,Pinellas,FL,Tampa,88,3179000,36125.0,93,5707000,61365.591397849465,-5,-2528000
2017,county,48085,Collin,12103,Pinellas,FL,Tampa,88,3299000,37488.63636363636,113,4567000,40415.929203539825,-25,-1268000
2017,county,48439,Tarrant,06061,Placer,CA,Sacramento,71,2172000,30591.549295774646,47,1845000,39255.31914893617,24,327000
2017,county,48113,Dallas,06061,Placer,CA,Sacramento,40,1888000,47200.0,55,2578000,46872.72727272727,-15,-690000
2017,county,48121,Denton,06061,Placer,CA,Sacramento,51,2870000,56274.509803921566,52,1845000,35480.769230769234,-1,1025000
2017,county,48439,Tarrant,29165,Platte,MO,Kansas City,67,3158000,47134.32835820896,42,1486000,35380.95238095238,25,1672000
2017,county,48439,Tarrant,12105,Polk,FL,Orlando,101,2042000,20217.821782178216,160,3837000,23981.25,-59,-1795000
2017,county,48439,Tarrant,19153,Polk,IA,Rural Iowa,73,2351000,32205.479452054795,75,2129000,28386.666666666668,-2,222000
2017,county,48439,Tarrant,48373,Polk,TX,Rural Texas,45,1175000,26111.11111111111,107,4257000,39785.04672897196,-62,-3082000
2017,county,48113,Dallas,19153,Polk,IA,Rural Iowa,93,3086000,33182.79569892473,90,2185000,24277.777777777777,3,901000
2017,county,48113,Dallas,12105,Polk,FL,Orlando,96,2345000,24427.083333333332,82,2795000,34085.365853658535,14,-450000
2017,county,48121,Denton,19153,Polk,IA,Rural Iowa,32,1185000,37031.25,40,1156000,28900.0,-8,29000
2017,county,48085,Collin,19153,Polk,IA,Rural Iowa,96,3326000,34645.833333333336,44,1939000,44068.181818181816,52,1387000
2017,county,48439,Tarrant,48375,Potter,TX,Rural Texas,264,5310000,20113.636363636364,123,2621000,21308.943089430893,141,2689000
2017,county,48113,Dallas,48375,Potter,TX,Rural Texas,146,4198000,28753.424657534248,122,2808000,23016.39344262295,24,1390000
2017,county,48121,Denton,48375,Potter,TX,Rural Texas,71,1450000,20422.535211267605,60,2200000,36666.666666666664,11,-750000
2017,county,48439,Tarrant,24033,Prince George,MD,Rural Maryland,160,4076000,25475.0,90,3012000,33466.666666666664,70,1064000
2017,county,48113,Dallas,24033,Prince George,MD,Rural Maryland,175,4862000,27782.85714285714,119,3109000,26126.050420168067,56,1753000
2017,county,48439,Tarrant,51153,Prince William,VA,Rural Virginia,134,6716000,50119.40298507463,89,2060000,23146.067415730337,45,4656000
2017,county,48113,Dallas,51153,Prince William,VA,Rural Virginia,96,2691000,28031.25,60,1655000,27583.333333333332,36,1036000
2017,county,48439,Tarrant,44007,Providence,RI,Providence,45,1483000,32955.555555555555,36,1109000,30805.555555555555,9,374000
2017,county,48113,Dallas,44007,Providence,RI,Providence,104,3599000,34605.769230769234,54,2651000,49092.59259259259,50,948000
2017,county,48439,Tarrant,08101,Pueblo,CO,Rural Colorado,43,413000,9604.651162790698,50,746000,14920.0,-7,-333000
2017,county,48439,Tarrant,05119,Pulaski,AR,Little Rock,374,11147000,29804.8128342246,192,5628000,29312.5,182,5519000
2017,county,48113,Dallas,05119,Pulaski,AR,Little Rock,472,16960000,35932.20338983051,328,8688000,26487.80487804878,144,8272000
2017,county,48121,Denton,05119,Pulaski,AR,Little Rock,205,5907000,28814.634146341465,71,2238000,31521.12676056338,134,3669000
2017,county,48085,Collin,05119,Pulaski,AR,Little Rock,226,7622000,33725.66371681416,102,3369000,33029.41176470588,124,4253000
2017,county,48439,Tarrant,36081,Queens,NY,New York,328,7069000,21551.829268292684,77,1909000,24792.20779220779,251,5160000
2017,county,48113,Dallas,36081,Queens,NY,New York,319,11263000,35307.21003134796,128,5247000,40992.1875,191,6016000
2017,county,48121,Denton,36081,Queens,NY,New York,142,5307000,37373.23943661972,42,1309000,31166.666666666668,100,3998000
2017,county,48085,Collin,36081,Queens,NY,New York,280,9138000,32635.714285714286,78,2502000,32076.923076923078,202,6636000
2017,county,48113,Dallas,48379,Rains,TX,Rural Texas,43,935000,21744.18604651163,142,3554000,25028.169014084506,-99,-2619000
2017,county,48439,Tarrant,27123,Ramsey,MN,Minneapolis,62,2385000,38467.74193548387,85,1576000,18541.176470588234,-23,809000
2017,county,48113,Dallas,27123,Ramsey,MN,Minneapolis,117,2967000,25358.97435897436,81,3317000,40950.61728395062,36,-350000
2017,county,48439,Tarrant,48381,Randall,TX,Rural Texas,385,11829000,30724.675324675325,166,4507000,27150.602409638555,219,7322000
2017,county,48113,Dallas,48381,Randall,TX,Rural Texas,159,6277000,39477.987421383645,105,3300000,31428.571428571428,54,2977000
2017,county,48121,Denton,48381,Randall,TX,Rural Texas,157,4661000,29687.898089171973,104,2779000,26721.153846153848,53,1882000
2017,county,48085,Collin,48381,Randall,TX,Rural Texas,148,4791000,32371.62162162162,59,1932000,32745.762711864405,89,2859000
2017,county,48439,Tarrant,28121,Rankin,MS,Jackson,65,936000,14400.0,43,1157000,26906.976744186046,22,-221000
2017,county,48113,Dallas,22079,Rapides Parish,LA,Rural Louisiana,104,3401000,32701.923076923078,44,880000,20000.0,60,2521000
2017,county,48113,Dallas,45079,Richland,SC,Columbia,83,3076000,37060.24096385542,51,1660000,32549.019607843136,32,1416000
2017,county,48439,Tarrant,06065,Riverside,CA,San Bernardino-Riverside,553,13470000,24358.047016274864,327,7619000,23299.694189602447,226,5851000
2017,county,48113,Dallas,06065,Riverside,CA,San Bernardino-Riverside,299,7773000,25996.655518394648,252,9484000,37634.920634920636,47,-1711000
2017,county,48121,Denton,06065,Riverside,CA,San Bernardino-Riverside,324,12907000,39836.41975308642,132,4068000,30818.18181818182,192,8839000
2017,county,48085,Collin,06065,Riverside,CA,San Bernardino-Riverside,342,11333000,33137.4269005848,115,4056000,35269.565217391304,227,7277000
2017,county,48439,Tarrant,48397,Rockwall,TX,Dallas-Fort Worth,304,11191000,36812.5,391,19281000,49312.02046035806,-87,-8090000
2017,county,48113,Dallas,48397,Rockwall,TX,Dallas-Fort Worth,2139,80486000,37627.86348761103,4625,160873000,34783.35135135135,-2486,-80387000
2017,county,48121,Denton,48397,Rockwall,TX,Dallas-Fort Worth,271,11574000,42708.487084870845,482,17269000,35827.800829875516,-211,-5695000
2017,county,48085,Collin,48397,Rockwall,TX,Dallas-Fort Worth,1134,36660000,32328.042328042327,1660,67112000,40428.9156626506,-526,-30452000
2017,county,48439,Tarrant,40131,Rogers,OK,Tulsa,59,2204000,37355.93220338983,80,2439000,30487.5,-21,-235000
2017,county,48439,Tarrant,48401,Rusk,TX,Rural Texas,58,1435000,24741.379310344826,51,734000,14392.156862745098,7,701000
2017,county,48113,Dallas,48401,Rusk,TX,Rural Texas,62,1367000,22048.387096774193,89,2151000,24168.539325842696,-27,-784000
2017,county,48439,Tarrant,47149,Rutherford,TN,Nashville,85,2741000,32247.058823529413,88,2663000,30261.363636363636,-3,78000
2017,county,48113,Dallas,47149,Rutherford,TN,Nashville,46,1163000,25282.608695652172,45,1294000,28755.555555555555,1,-131000
2017,county,48439,Tarrant,06067,Sacramento,CA,Sacramento,229,6023000,26301.310043668123,167,3620000,21676.646706586827,62,2403000
2017,county,48113,Dallas,06067,Sacramento,CA,Sacramento,258,9031000,35003.875968992244,199,7801000,39201.005025125625,59,1230000
2017,county,48121,Denton,06067,Sacramento,CA,Sacramento,111,4571000,41180.18018018018,62,1802000,29064.516129032258,49,2769000
2017,county,48085,Collin,06067,Sacramento,CA,Sacramento,128,4328000,33812.5,86,2599000,30220.93023255814,42,1729000
2017,county,48439,Tarrant,05125,Saline,AR,Little Rock,53,2046000,38603.77358490566,65,2501000,38476.92307692308,-12,-455000
2017,county,48113,Dallas,05125,Saline,AR,Little Rock,42,832000,19809.52380952381,35,1137000,32485.714285714286,7,-305000
2017,county,48085,Collin,05125,Saline,AR,Little Rock,54,1325000,24537.037037037036,63,3370000,53492.06349206349,-9,-2045000
2017,county,48439,Tarrant,49035,Salt Lake,UT,Salt Lake,282,9077000,32187.943262411347,221,6199000,28049.773755656108,61,2878000
2017,county,48113,Dallas,49035,Salt Lake,UT,Salt Lake,244,8890000,36434.42622950819,240,9482000,39508.333333333336,4,-592000
2017,county,48121,Denton,49035,Salt Lake,UT,Salt Lake,190,6366000,33505.26315789474,134,5171000,38589.55223880597,56,1195000
2017,county,48085,Collin,49035,Salt Lake,UT,Salt Lake,233,8068000,34626.609442060086,148,4459000,30128.37837837838,85,3609000
2017,county,48439,Tarrant,06071,San Bernardino,CA,San Bernardino-Riverside,528,10928000,20696.969696969696,272,5984000,22000.0,256,4944000
2017,county,48113,Dallas,06071,San Bernardino,CA,San Bernardino-Riverside,381,10844000,28461.94225721785,226,6340000,28053.097345132745,155,4504000
2017,county,48121,Denton,06071,San Bernardino,CA,San Bernardino-Riverside,259,7508000,28988.41698841699,108,2235000,20694.444444444445,151,5273000
2017,county,48085,Collin,06071,San Bernardino,CA,San Bernardino-Riverside,286,7459000,26080.41958041958,84,2662000,31690.47619047619,202,4797000
2017,county,48439,Tarrant,06073,San Diego,CA,San Diego,1152,29582000,25678.819444444445,658,17806000,27060.79027355623,494,11776000
2017,county,48113,Dallas,06073,San Diego,CA,San Diego,792,27598000,34845.9595959596,655,30105000,45961.8320610687,137,-2507000
2017,county,48121,Denton,06073,San Diego,CA,San Diego,451,18370000,40731.70731707317,199,9572000,48100.502512562816,252,8798000
2017,county,48085,Collin,06073,San Diego,CA,San Diego,707,33573000,47486.56294200849,436,19198000,44032.11009174312,271,14375000
2017,county,48439,Tarrant,06075,San Francisco,CA,Bay Area,58,3306000,57000.0,57,4191000,73526.31578947368,1,-885000
2017,county,48113,Dallas,06075,San Francisco,CA,Bay Area,248,24077000,97084.67741935483,257,38004000,147875.48638132296,-9,-13927000
2017,county,48121,Denton,06075,San Francisco,CA,Bay Area,37,2319000,62675.67567567567,26,1714000,65923.07692307692,11,605000
2017,county,48085,Collin,06075,San Francisco,CA,Bay Area,71,13511000,190295.77464788733,88,6230000,70795.45454545454,-17,7281000
2017,county,48439,Tarrant,06077,San Joaquin,CA,Bay Area,107,3213000,30028.03738317757,60,828000,13800.0,47,2385000
2017,county,48113,Dallas,06077,San Joaquin,CA,Bay Area,102,2849000,27931.37254901961,49,910000,18571.428571428572,53,1939000
2017,county,48439,Tarrant,06081,San Mateo,CA,Bay Area,101,3805000,37673.267326732675,63,2109000,33476.19047619047,38,1696000
2017,county,48113,Dallas,06081,San Mateo,CA,Bay Area,176,16300000,92613.63636363637,135,8430000,62444.444444444445,41,7870000
2017,county,48121,Denton,06081,San Mateo,CA,Bay Area,77,5071000,65857.14285714286,33,1581000,47909.09090909091,44,3490000
2017,county,48085,Collin,06081,San Mateo,CA,Bay Area,89,8479000,95269.66292134831,69,5127000,74304.34782608696,20,3352000
2017,county,48439,Tarrant,48409,San Patricio,TX,Rural Texas,54,879000,16277.777777777777,58,1217000,20982.758620689656,-4,-338000
2017,county,48439,Tarrant,35043,Sandoval,NM,Albuquerque,51,1577000,30921.56862745098,55,1849000,33618.181818181816,-4,-272000
2017,county,48113,Dallas,06083,Santa Barbara,CA,Rural California,67,4468000,66686.5671641791,41,3045000,74268.29268292683,26,1423000
2017,county,48439,Tarrant,06085,Santa Clara,CA,Bay Area,263,14380000,54676.80608365019,198,7310000,36919.19191919192,65,7070000
2017,county,48113,Dallas,06085,Santa Clara,CA,Bay Area,583,29918000,51317.32418524871,489,28984000,59271.9836400818,94,934000
2017,county,48121,Denton,06085,Santa Clara,CA,Bay Area,252,12961000,51432.53968253968,118,13179000,111686.44067796611,134,-218000
2017,county,48085,Collin,06085,Santa Clara,CA,Bay Area,749,42382000,56584.77970627503,364,25804000,70890.10989010989,385,16578000
2017,county,48439,Tarrant,35049,Santa Fe,NM,Rural New Mexico,37,1742000,47081.08108108108,51,1829000,35862.74509803922,-14,-87000
2017,county,48113,Dallas,35049,Santa Fe,NM,Rural New Mexico,54,2466000,45666.666666666664,83,8813000,106180.72289156627,-29,-6347000
2017,county,48439,Tarrant,12113,Santa Rosa,FL,FL Panhandle,54,1357000,25129.62962962963,62,2305000,37177.41935483871,-8,-948000
2017,county,48439,Tarrant,12115,Sarasota,FL,S.W. Florida,39,1121000,28743.589743589742,40,1867000,46675.0,-1,-746000
2017,county,48113,Dallas,12115,Sarasota,FL,S.W. Florida,32,1322000,41312.5,59,3688000,62508.47457627119,-27,-2366000
2017,county,48113,Dallas,31153,Sarpy,NE,Omaha,29,932000,32137.931034482757,44,854000,19409.090909090908,-15,78000
2017,county,48439,Tarrant,05131,Sebastian,AR,Rural Arkansas,51,1026000,20117.647058823528,58,1759000,30327.58620689655,-7,-733000
2017,county,48113,Dallas,05131,Sebastian,AR,Rural Arkansas,67,2263000,33776.119402985074,77,1820000,23636.363636363636,-10,443000
2017,county,48439,Tarrant,20173,Sedgwick,KS,Rural Kansas,324,9636000,29740.74074074074,223,6764000,30331.838565022423,101,2872000
2017,county,48113,Dallas,20173,Sedgwick,KS,Rural Kansas,279,9108000,32645.16129032258,128,4659000,36398.4375,151,4449000
2017,county,48121,Denton,20173,Sedgwick,KS,Rural Kansas,122,6362000,52147.54098360656,74,2507000,33878.37837837838,48,3855000
2017,county,48085,Collin,20173,Sedgwick,KS,Rural Kansas,139,3918000,28187.05035971223,79,3098000,39215.18987341772,60,820000
2017,county,48439,Tarrant,12117,Seminole,FL,Orlando,114,4215000,36973.68421052631,76,2900000,38157.89473684211,38,1315000
2017,county,48113,Dallas,12117,Seminole,FL,Orlando,79,2925000,37025.3164556962,81,3051000,37666.666666666664,-2,-126000
2017,county,48121,Denton,12117,Seminole,FL,Orlando,67,2438000,36388.05970149254,50,1785000,35700.0,17,653000
2017,county,48085,Collin,12117,Seminole,FL,Orlando,91,3982000,43758.241758241755,59,3519000,59644.06779661017,32,463000
2017,county,48439,Tarrant,20177,Shawnee,KS,Rural Kansas,74,2433000,32878.37837837838,46,1991000,43282.608695652176,28,442000
2017,county,48439,Tarrant,47157,Shelby,TN,Memphis,505,12218000,24194.059405940596,231,5976000,25870.12987012987,274,6242000
2017,county,48113,Dallas,47157,Shelby,TN,Memphis,552,14530000,26322.463768115944,305,9028000,29600.0,247,5502000
2017,county,48121,Denton,47157,Shelby,TN,Memphis,268,11092000,41388.05970149254,111,3712000,33441.44144144144,157,7380000
2017,county,48085,Collin,47157,Shelby,TN,Memphis,287,9528000,33198.606271777004,126,4827000,38309.52380952381,161,4701000
2017,county,48439,Tarrant,48423,Smith,TX,Rural Texas,683,21185000,31017.56954612006,581,19259000,33148.02065404475,102,1926000
2017,county,48113,Dallas,48423,Smith,TX,Rural Texas,983,28319000,28808.748728382503,775,21728000,28036.129032258064,208,6591000
2017,county,48121,Denton,48423,Smith,TX,Rural Texas,299,9913000,33153.846153846156,263,8575000,32604.562737642587,36,1338000
2017,county,48085,Collin,48423,Smith,TX,Rural Texas,349,10649000,30512.893982808022,340,12769000,37555.882352941175,9,-2120000
2017,county,48439,Tarrant,53061,Snohomish,WA,Seattle,166,6029000,36319.27710843374,111,3798000,34216.21621621621,55,2231000
2017,county,48113,Dallas,53061,Snohomish,WA,Seattle,105,3691000,35152.380952380954,148,5458000,36878.37837837838,-43,-1767000
2017,county,48121,Denton,53061,Snohomish,WA,Seattle,79,2792000,35341.77215189873,95,3391000,35694.73684210526,-16,-599000
2017,county,48085,Collin,53061,Snohomish,WA,Seattle,167,6819000,40832.33532934132,121,4512000,37289.25619834711,46,2307000
2017,county,48439,Tarrant,06095,Solano,CA,Bay Area,102,2548000,24980.392156862745,64,965000,15078.125,38,1583000
2017,county,48113,Dallas,06095,Solano,CA,Bay Area,44,1500000,34090.90909090909,29,1070000,36896.55172413793,15,430000
2017,county,48113,Dallas,34035,Somerset,NJ,New York,63,5816000,92317.46031746031,37,2131000,57594.59459459459,26,3685000
2017,county,48085,Collin,34035,Somerset,NJ,New York,152,7409000,48743.42105263158,53,2827000,53339.622641509435,99,4582000
2017,county,48439,Tarrant,48425,Somervell,TX,Rural Texas,58,1986000,34241.379310344826,151,5129000,33966.887417218546,-93,-3143000
2017,county,48439,Tarrant,53063,Spokane,WA,Spokane,92,2225000,24184.782608695652,45,3235000,71888.88888888889,47,-1010000
2017,county,48085,Collin,53063,Spokane,WA,Spokane,52,1536000,29538.46153846154,54,1729000,32018.51851851852,-2,-193000
2017,county,48439,Tarrant,29183,St. Charles,MO,St. Louis,118,4869000,41262.71186440678,46,2372000,51565.217391304344,72,2497000
2017,county,48113,Dallas,29183,St. Charles,MO,St. Louis,118,5137000,43533.898305084746,52,2852000,54846.153846153844,66,2285000
2017,county,48121,Denton,29183,St. Charles,MO,St. Louis,85,5271000,62011.76470588235,53,2226000,42000.0,32,3045000
2017,county,48085,Collin,29183,St. Charles,MO,St. Louis,140,6379000,45564.28571428572,82,2677000,32646.341463414636,58,3702000
2017,county,48439,Tarrant,17163,St. Clair,IL,St. Louis,90,1819000,20211.11111111111,56,807000,14410.714285714286,34,1012000
2017,county,48439,Tarrant,12109,St. Johns,FL,Jacksonville,42,1887000,44928.57142857143,54,3391000,62796.2962962963,-12,-1504000
2017,county,48085,Collin,12109,St. Johns,FL,Jacksonville,68,2539000,37338.23529411765,72,2798000,38861.11111111111,-4,-259000
2017,county,48113,Dallas,18141,St. Joseph,IN,Rural Indiana,59,2085000,35338.983050847455,47,1218000,25914.893617021276,12,867000
2017,county,48439,Tarrant,29189,St. Louis,MO,St. Louis,374,11551000,30885.026737967914,155,4901000,31619.354838709678,219,6650000
2017,county,48113,Dallas,29189,St. Louis,MO,St. Louis,459,19341000,42137.25490196078,253,12303000,48628.45849802371,206,7038000
2017,county,48121,Denton,29189,St. Louis,MO,St. Louis,265,10957000,41347.16981132075,70,4233000,60471.42857142857,195,6724000
2017,county,48085,Collin,29189,St. Louis,MO,St. Louis,455,15713000,34534.06593406593,161,6610000,41055.90062111801,294,9103000
2017,county,48439,Tarrant,29510,St. Louis city,MO,Rural Missouri,68,1095000,16102.941176470587,48,1692000,35250.0,20,-597000
2017,county,48113,Dallas,29510,St. Louis city,MO,Rural Missouri,172,7841000,45587.20930232558,75,2903000,38706.666666666664,97,4938000
2017,county,48085,Collin,29510,St. Louis city,MO,Rural Missouri,49,1604000,32734.69387755102,32,1143000,35718.75,17,461000
2017,county,48439,Tarrant,22103,St. Tammany Parish,LA,New Orleans,86,2448000,28465.116279069767,72,3278000,45527.77777777778,14,-830000
2017,county,48113,Dallas,22103,St. Tammany Parish,LA,New Orleans,71,2591000,36492.957746478874,47,4435000,94361.70212765958,24,-1844000
2017,county,48439,Tarrant,36103,Suffolk,NY,New York,132,4715000,35719.69696969697,46,941000,20456.521739130436,86,3774000
2017,county,48439,Tarrant,25025,Suffolk,MA,Boston,86,3622000,42116.27906976744,43,1827000,42488.37209302326,43,1795000
2017,county,48113,Dallas,25025,Suffolk,MA,Boston,198,14431000,72883.83838383839,150,9146000,60973.333333333336,48,5285000
2017,county,48113,Dallas,36103,Suffolk,NY,New York,164,4842000,29524.39024390244,89,3690000,41460.67415730337,75,1152000
2017,county,48085,Collin,36103,Suffolk,NY,New York,93,4436000,47698.92473118279,55,2415000,43909.09090909091,38,2021000
2017,county,48085,Collin,25025,Suffolk,MA,Boston,42,2040000,48571.42857142857,36,1693000,47027.77777777778,6,347000
2017,county,48113,Dallas,39153,Summit,OH,Rural Ohio,54,2077000,38462.96296296296,63,1339000,21253.968253968254,-9,738000
2017,county,48113,Dallas,48439,Tarrant,TX,Dallas-Fort Worth,23773,682602000,28713.330248601356,29810,830136000,27847.567930224755,-6037,-147534000
2017,county,48121,Denton,48439,Tarrant,TX,Dallas-Fort Worth,12178,472734000,38818.68943997372,9307,321747000,34570.43085849361,2871,150987000
2017,county,48085,Collin,48439,Tarrant,TX,Dallas-Fort Worth,3958,139368000,35211.723092470944,3350,106552000,31806.567164179105,608,32816000
2017,county,48439,Tarrant,48441,Taylor,TX,Rural Texas,651,16269000,24990.78341013825,386,8398000,21756.476683937824,265,7871000
2017,county,48113,Dallas,48441,Taylor,TX,Rural Texas,322,7550000,23447.2049689441,243,6307000,25954.732510288064,79,1243000
2017,county,48121,Denton,48441,Taylor,TX,Rural Texas,217,6157000,28373.271889400923,107,2844000,26579.439252336448,110,3313000
2017,county,48085,Collin,48441,Taylor,TX,Rural Texas,123,3396000,27609.756097560974,101,2945000,29158.41584158416,22,451000
2017,county,48439,Tarrant,53067,Thurston,WA,Rural Washington,50,1223000,24460.0,59,1729000,29305.084745762713,-9,-506000
2017,county,48439,Tarrant,48449,Titus,TX,Rural Texas,73,1765000,24178.08219178082,65,1248000,19200.0,8,517000
2017,county,48113,Dallas,48449,Titus,TX,Rural Texas,102,1869000,18323.529411764706,114,1392000,12210.526315789473,-12,477000
2017,county,48439,Tarrant,48451,Tom Green,TX,Rural Texas,319,9014000,28257.05329153605,199,5183000,26045.226130653267,120,3831000
2017,county,48113,Dallas,48451,Tom Green,TX,Rural Texas,184,5191000,28211.956521739132,126,3265000,25912.698412698413,58,1926000
2017,county,48121,Denton,48451,Tom Green,TX,Rural Texas,103,2687000,26087.3786407767,70,1249000,17842.85714285714,33,1438000
2017,county,48085,Collin,48451,Tom Green,TX,Rural Texas,97,2163000,22298.96907216495,62,1878000,30290.322580645163,35,285000
2017,county,48439,Tarrant,48453,Travis,TX,Austin,1494,52385000,35063.587684069615,1409,59659000,42341.37686302342,85,-7274000
2017,county,48113,Dallas,48453,Travis,TX,Austin,2473,118388000,47872.21997573797,2513,129284000,51446.080382013526,-40,-10896000
2017,county,48121,Denton,48453,Travis,TX,Austin,738,29966000,40604.33604336043,796,29941000,37614.3216080402,-58,25000
2017,county,48085,Collin,48453,Travis,TX,Austin,969,42823000,44192.98245614035,1056,52531000,49745.26515151515,-87,-9708000
2017,county,48439,Tarrant,40143,Tulsa,OK,Tulsa,522,14775000,28304.597701149425,367,11971000,32618.528610354224,155,2804000
2017,county,48113,Dallas,40143,Tulsa,OK,Tulsa,608,34528000,56789.47368421053,381,12606000,33086.61417322834,227,21922000
2017,county,48121,Denton,40143,Tulsa,OK,Tulsa,316,11831000,37439.873417721516,195,8221000,42158.97435897436,121,3610000
2017,county,48085,Collin,40143,Tulsa,OK,Tulsa,344,11425000,33212.20930232558,230,9916000,43113.04347826087,114,1509000
2017,county,48439,Tarrant,48459,Upshur,TX,Rural Texas,47,1595000,33936.17021276596,70,1718000,24542.85714285714,-23,-123000
2017,county,48113,Dallas,48459,Upshur,TX,Rural Texas,55,931000,16927.272727272728,69,1531000,22188.405797101448,-14,-600000
2017,county,48439,Tarrant,49049,Utah,UT,Rural Utah,192,3436000,17895.833333333332,187,3735000,19973.26203208556,5,-299000
2017,county,48113,Dallas,49049,Utah,UT,Rural Utah,163,3619000,22202.453987730063,96,2395000,24947.916666666668,67,1224000
2017,county,48121,Denton,49049,Utah,UT,Rural Utah,117,2772000,23692.30769230769,134,3385000,25261.194029850747,-17,-613000
2017,county,48085,Collin,49049,Utah,UT,Rural Utah,130,2227000,17130.76923076923,206,6060000,29417.47572815534,-76,-3833000
2017,county,48439,Tarrant,48465,Val Verde,TX,Rural Texas,57,1416000,24842.105263157893,68,812000,11941.176470588236,-11,604000
2017,county,48113,Dallas,48465,Val Verde,TX,Rural Texas,61,752000,12327.868852459016,33,679000,20575.757575757576,28,73000
2017,county,48439,Tarrant,48467,Van Zandt,TX,Rural Texas,94,2093000,22265.957446808512,237,9162000,38658.22784810127,-143,-7069000
2017,county,48113,Dallas,48467,Van Zandt,TX,Rural Texas,258,6211000,24073.643410852714,728,18628000,25587.91208791209,-470,-12417000
2017,county,48121,Denton,48467,Van Zandt,TX,Rural Texas,71,1629000,22943.661971830985,131,4829000,36862.59541984733,-60,-3200000
2017,county,48085,Collin,48467,Van Zandt,TX,Rural Texas,62,1572000,25354.83870967742,170,4735000,27852.941176470587,-108,-3163000
2017,county,48439,Tarrant,06111,Ventura,CA,Los Angeles,257,7734000,30093.385214007783,95,2706000,28484.21052631579,162,5028000
2017,county,48113,Dallas,06111,Ventura,CA,Los Angeles,128,8321000,65007.8125,65,1947000,29953.846153846152,63,6374000
2017,county,48121,Denton,06111,Ventura,CA,Los Angeles,119,4882000,41025.21008403361,50,1970000,39400.0,69,2912000
2017,county,48085,Collin,06111,Ventura,CA,Los Angeles,270,10955000,40574.07407407407,90,3088000,34311.11111111111,180,7867000
2017,county,48439,Tarrant,48469,Victoria,TX,Rural Texas,60,1762000,29366.666666666668,45,1399000,31088.88888888889,15,363000
2017,county,48439,Tarrant,51810,Virginia Beach city,VA,Hampton Roads,199,4372000,21969.849246231155,123,2300000,18699.18699186992,76,2072000
2017,county,48113,Dallas,51810,Virginia Beach city,VA,Hampton Roads,101,3855000,38168.316831683165,72,1875000,26041.666666666668,29,1980000
2017,county,48439,Tarrant,12127,Volusia,FL,Atlantic Coast,73,2594000,35534.24657534246,65,2194000,33753.846153846156,8,400000
2017,county,48113,Dallas,12127,Volusia,FL,Atlantic Coast,63,1564000,24825.396825396827,66,1625000,24621.21212121212,-3,-61000
2017,county,48085,Collin,12127,Volusia,FL,Atlantic Coast,46,1247000,27108.695652173912,43,1540000,35813.95348837209,3,-293000
2017,county,48439,Tarrant,37183,Wake,NC,Raleigh,203,8044000,39625.6157635468,164,6661000,40615.85365853659,39,1383000
2017,county,48113,Dallas,37183,Wake,NC,Raleigh,233,10720000,46008.58369098712,247,12755000,51639.67611336032,-14,-2035000
2017,county,48121,Denton,37183,Wake,NC,Raleigh,144,7146000,49625.0,90,4646000,51622.22222222222,54,2500000
2017,county,48085,Collin,37183,Wake,NC,Raleigh,267,13426000,50284.644194756554,174,7360000,42298.85057471264,93,6066000
2017,county,48439,Tarrant,48471,Walker,TX,Rural Texas,66,1310000,19848.484848484848,45,967000,21488.88888888889,21,343000
2017,county,48113,Dallas,48471,Walker,TX,Rural Texas,91,1574000,17296.703296703297,59,1863000,31576.271186440677,32,-289000
2017,county,48439,Tarrant,05143,Washington,AR,Rural Arkansas,145,4888000,33710.34482758621,119,3190000,26806.722689075632,26,1698000
2017,county,48439,Tarrant,41067,Washington,OR,Portland,98,3498000,35693.87755102041,84,2480000,29523.809523809523,14,1018000
2017,county,48113,Dallas,05143,Washington,AR,Rural Arkansas,140,7206000,51471.42857142857,159,6464000,40654.088050314465,-19,742000
2017,county,48113,Dallas,41067,Washington,OR,Portland,129,5057000,39201.5503875969,153,5456000,35660.13071895425,-24,-399000
2017,county,48121,Denton,05143,Washington,AR,Rural Arkansas,65,1649000,25369.23076923077,83,2384000,28722.89156626506,-18,-735000
2017,county,48121,Denton,41067,Washington,OR,Portland,76,3221000,42381.57894736842,69,3001000,43492.75362318841,7,220000
2017,county,48085,Collin,41067,Washington,OR,Portland,181,6958000,38441.988950276245,110,6445000,58590.90909090909,71,513000
2017,county,48085,Collin,05143,Washington,AR,Rural Arkansas,83,3781000,45554.21686746988,93,3244000,34881.720430107525,-10,537000
2017,county,48439,Tarrant,32031,Washoe,NV,Rural Nevada,84,2627000,31273.809523809523,89,2597000,29179.775280898877,-5,30000
2017,county,48113,Dallas,32031,Washoe,NV,Rural Nevada,82,2283000,27841.463414634145,84,6135000,73035.71428571429,-2,-3852000
2017,county,48085,Collin,32031,Washoe,NV,Rural Nevada,55,2751000,50018.181818181816,32,2180000,68125.0,23,571000
2017,county,48439,Tarrant,26161,Washtenaw,MI,Rural Michigan,54,1971000,36500.0,36,2393000,66472.22222222222,18,-422000
2017,county,48113,Dallas,26161,Washtenaw,MI,Rural Michigan,84,3559000,42369.04761904762,61,2101000,34442.62295081967,23,1458000
2017,county,48121,Denton,26161,Washtenaw,MI,Rural Michigan,48,2171000,45229.166666666664,59,2463000,41745.76271186441,-11,-292000
2017,county,48439,Tarrant,55133,Waukesha,WI,Milwaukee,84,2388000,28428.571428571428,59,2599000,44050.84745762712,25,-211000
2017,county,48113,Dallas,55133,Waukesha,WI,Milwaukee,60,4261000,71016.66666666667,50,1822000,36440.0,10,2439000
2017,county,48439,Tarrant,26163,Wayne,MI,Detroit,268,7407000,27638.059701492537,173,3745000,21647.398843930634,95,3662000
2017,county,48113,Dallas,26163,Wayne,MI,Detroit,243,8268000,34024.69135802469,197,5653000,28695.431472081218,46,2615000
2017,county,48121,Denton,26163,Wayne,MI,Detroit,103,4214000,40912.6213592233,54,1304000,24148.14814814815,49,2910000
2017,county,48085,Collin,26163,Wayne,MI,Detroit,153,5291000,34581.69934640523,112,4104000,36642.857142857145,41,1187000
2017,county,48439,Tarrant,48479,Webb,TX,Rural Texas,138,2293000,16615.942028985508,95,1477000,15547.368421052632,43,816000
2017,county,48113,Dallas,48479,Webb,TX,Rural Texas,230,3150000,13695.652173913044,190,2859000,15047.368421052632,40,291000
2017,county,48439,Tarrant,08123,Weld,CO,Rural Colorado,73,1427000,19547.945205479453,94,2246000,23893.617021276597,-21,-819000
2017,county,48113,Dallas,08123,Weld,CO,Rural Colorado,50,1200000,24000.0,59,2079000,35237.28813559322,-9,-879000
2017,county,48439,Tarrant,36119,Westchester,NY,New York,91,7022000,77164.83516483517,56,1601000,28589.285714285714,35,5421000
2017,county,48113,Dallas,36119,Westchester,NY,New York,147,8579000,58360.54421768708,78,6614000,84794.8717948718,69,1965000
2017,county,48085,Collin,36119,Westchester,NY,New York,112,7421000,66258.92857142857,49,3372000,68816.32653061225,63,4049000
2017,county,48439,Tarrant,48485,Wichita,TX,Rural Texas,573,15197000,26521.815008726004,378,7938000,21000.0,195,7259000
2017,county,48113,Dallas,48485,Wichita,TX,Rural Texas,296,7987000,26983.108108108107,285,5658000,19852.63157894737,11,2329000
2017,county,48121,Denton,48485,Wichita,TX,Rural Texas,218,5922000,27165.1376146789,156,5397000,34596.153846153844,62,525000
2017,county,48085,Collin,48485,Wichita,TX,Rural Texas,223,6131000,27493.2735426009,137,3785000,27627.73722627737,86,2346000
2017,county,48439,Tarrant,48487,Wilbarger,TX,Rural Texas,47,848000,18042.55319148936,45,828000,18400.0,2,20000
2017,county,48439,Tarrant,17197,Will,IL,Chicago,169,6409000,37923.07692307692,61,1928000,31606.55737704918,108,4481000
2017,county,48113,Dallas,17197,Will,IL,Chicago,110,3349000,30445.454545454544,65,2741000,42169.230769230766,45,608000
2017,county,48439,Tarrant,48491,Williamson,TX,Austin,748,23451000,31351.604278074865,849,30707000,36168.433451118966,-101,-7256000
2017,county,48439,Tarrant,47187,Williamson,TN,Nashville,55,2036000,37018.181818181816,130,7813000,60100.0,-75,-5777000
2017,county,48113,Dallas,48491,Williamson,TX,Austin,588,25918000,44078.231292517004,716,28671000,40043.296089385476,-128,-2753000
2017,county,48113,Dallas,47187,Williamson,TN,Nashville,53,4456000,84075.47169811321,97,6996000,72123.71134020618,-44,-2540000
2017,county,48121,Denton,48491,Williamson,TX,Austin,433,14336000,33108.54503464203,550,19590000,35618.181818181816,-117,-5254000
2017,county,48121,Denton,47187,Williamson,TN,Nashville,52,3470000,66730.76923076923,64,3984000,62250.0,-12,-514000
2017,county,48085,Collin,48491,Williamson,TX,Austin,627,22950000,36602.87081339713,615,23447000,38125.20325203252,12,-497000
2017,county,48085,Collin,47187,Williamson,TN,Nashville,69,4337000,62855.07246376811,131,7477000,57076.3358778626,-62,-3140000
2017,county,48113,Dallas,17201,Winnebago,IL,Rural Illinois,57,1265000,22192.98245614035,38,1108000,29157.894736842107,19,157000
2017,county,48439,Tarrant,48497,Wise,TX,Dallas-Fort Worth,1060,32804000,30947.169811320753,2720,76167000,28002.573529411766,-1660,-43363000
2017,county,48113,Dallas,48497,Wise,TX,Dallas-Fort Worth,106,2990000,28207.54716981132,210,6208000,29561.904761904763,-104,-3218000
2017,county,48121,Denton,48497,Wise,TX,Dallas-Fort Worth,522,16425000,31465.51724137931,1284,37190000,28964.17445482866,-762,-20765000
2017,county,48085,Collin,48497,Wise,TX,Dallas-Fort Worth,53,1212000,22867.924528301886,100,5490000,54900.0,-47,-4278000
2017,county,48439,Tarrant,48499,Wood,TX,Rural Texas,66,1603000,24287.878787878788,269,10061000,37401.48698884758,-203,-8458000
2017,county,48113,Dallas,48499,Wood,TX,Rural Texas,111,2524000,22738.73873873874,340,12615000,37102.94117647059,-229,-10091000
2017,county,48121,Denton,48499,Wood,TX,Rural Texas,59,1681000,28491.525423728814,110,3664000,33309.09090909091,-51,-1983000
2017,county,48085,Collin,48499,Wood,TX,Rural Texas,58,1704000,29379.310344827587,202,9068000,44891.08910891089,-144,-7364000
2017,county,48439,Tarrant,25027,Worcester,MA,Rural Massachusetts,68,4367000,64220.58823529412,39,1149000,29461.53846153846,29,3218000
2017,county,48113,Dallas,25027,Worcester,MA,Rural Massachusetts,85,3010000,35411.76470588235,45,1317000,29266.666666666668,40,1693000
2017,county,48439,Tarrant,45091,York,SC,Charlotte,58,2277000,39258.620689655174,48,2253000,46937.5,10,24000
2017,county,48439,Tarrant,48503,Young,TX,Rural Texas,70,2365000,33785.71428571428,95,2488000,26189.473684210527,-25,-123000
2017,total,48439,Tarrant,96000,,,,133488,4063175000,30438.50383555076,127016,4053006000,31909.412987340176,6472,10169000
2017,total,48113,Dallas,96000,,,,147754,5497881000,37209.693138595234,169719,6094877000,35911.57737200903,-21965,-596996000
2017,total,48121,Denton,96000,,,,94525,3744858000,39617.64612536366,75079,2743470000,36541.11003076759,19446,1001388000
2017,total,48085,Collin,96000,,,,106235,4166127000,39216.14345554666,81302,3522735000,43329.00789648471,24933,643392000
2018,county,48439,Tarrant,16001,Ada,ID,Rural Idaho,40,2048000,51200.0,65,2784000,42830.769230769234,-25,-736000
2018,county,48113,Dallas,16001,Ada,ID,Rural Idaho,50,1485000,29700.0,72,3922000,54472.22222222222,-22,-2437000
2018,county,48439,Tarrant,08001,Adams,CO,Denver,86,1976000,22976.74418604651,105,3322000,31638.095238095237,-19,-1346000
2018,county,48113,Dallas,08001,Adams,CO,Denver,91,2849000,31307.69230769231,76,3546000,46657.89473684211,15,-697000
2018,county,48121,Denton,08001,Adams,CO,Denver,64,2170000,33906.25,94,2639000,28074.468085106382,-30,-469000
2018,county,48085,Collin,08001,Adams,CO,Denver,74,1886000,25486.486486486487,56,1518000,27107.14285714286,18,368000
2018,county,48113,Dallas,12001,Alachua,FL,Rural Florida,28,741000,26464.285714285714,24,1198000,49916.666666666664,4,-457000
2018,county,48439,Tarrant,06001,Alameda,CA,Bay Area,211,13362000,63327.01421800948,126,5115000,40595.23809523809,85,8247000
2018,county,48113,Dallas,06001,Alameda,CA,Bay Area,370,16873000,45602.7027027027,261,11852000,45409.96168582376,109,5021000
2018,county,48121,Denton,06001,Alameda,CA,Bay Area,148,8762000,59202.7027027027,75,3324000,44320.0,73,5438000
2018,county,48085,Collin,06001,Alameda,CA,Bay Area,417,21366000,51237.410071942446,197,15749000,79944.16243654823,220,5617000
2018,county,48113,Dallas,51510,Alexandria city,VA,D.C.,75,4786000,63813.333333333336,35,2547000,72771.42857142857,40,2239000
2018,county,48439,Tarrant,42003,Allegheny,PA,Pittsburgh,98,5786000,59040.816326530614,92,4382000,47630.434782608696,6,1404000
2018,county,48113,Dallas,42003,Allegheny,PA,Pittsburgh,115,5706000,49617.391304347824,141,10502000,74482.2695035461,-26,-4796000
2018,county,48121,Denton,42003,Allegheny,PA,Pittsburgh,61,3318000,54393.44262295082,54,1624000,30074.074074074073,7,1694000
2018,county,48085,Collin,42003,Allegheny,PA,Pittsburgh,77,2929000,38038.96103896104,72,3579000,49708.333333333336,5,-650000
2018,county,48439,Tarrant,18003,Allen,IN,Rural Indiana,32,2135000,66718.75,43,1018000,23674.418604651164,-11,1117000
2018,county,48113,Dallas,18003,Allen,IN,Rural Indiana,56,2234000,39892.857142857145,113,1400000,12389.38053097345,-57,834000
2018,county,48113,Dallas,02020,Anchorage Borough,AK,Rural Alaska,67,2490000,37164.17910447761,43,1964000,45674.41860465116,24,526000
2018,county,48439,Tarrant,48001,Anderson,TX,Rural Texas,74,1366000,18459.45945945946,102,3210000,31470.58823529412,-28,-1844000
2018,county,48113,Dallas,48001,Anderson,TX,Rural Texas,85,1481000,17423.529411764706,122,2999000,24581.967213114753,-37,-1518000
2018,county,48439,Tarrant,48005,Angelina,TX,Rural Texas,142,2743000,19316.901408450703,43,1044000,24279.06976744186,99,1699000
2018,county,48113,Dallas,48005,Angelina,TX,Rural Texas,98,2350000,23979.591836734693,61,1001000,16409.83606557377,37,1349000
2018,county,48439,Tarrant,24003,Anne Arundel,MD,Baltimore,88,2225000,25284.090909090908,72,2364000,32833.333333333336,16,-139000
2018,county,48113,Dallas,24003,Anne Arundel,MD,Baltimore,65,6764000,104061.53846153847,58,2155000,37155.1724137931,7,4609000
2018,county,48439,Tarrant,08005,Arapahoe,CO,Denver,210,7097000,33795.23809523809,196,6779000,34586.73469387755,14,318000
2018,county,48113,Dallas,08005,Arapahoe,CO,Denver,197,10508000,53340.10152284264,280,14982000,53507.142857142855,-83,-4474000
2018,county,48121,Denton,08005,Arapahoe,CO,Denver,98,3620000,36938.77551020408,164,6389000,38957.31707317073,-66,-2769000
2018,county,48085,Collin,08005,Arapahoe,CO,Denver,187,6578000,35176.470588235294,176,7143000,40585.22727272727,11,-565000
2018,county,48439,Tarrant,51013,Arlington,VA,D.C.,32,2833000,88531.25,45,3384000,75200.0,-13,-551000
2018,county,48113,Dallas,51013,Arlington,VA,D.C.,91,5992000,65846.15384615384,97,11179000,115247.42268041238,-6,-5187000
2018,county,48085,Collin,51013,Arlington,VA,D.C.,44,2278000,51772.72727272727,40,1954000,48850.0,4,324000
2018,county,48113,Dallas,01003,Baldwin,AL,Mobile,42,1481000,35261.90476190476,41,2987000,72853.65853658537,1,-1506000
2018,county,48113,Dallas,24005,Baltimore,MD,Baltimore,106,3112000,29358.490566037737,48,2093000,43604.166666666664,58,1019000
2018,county,48113,Dallas,24510,Baltimore city,MD,Baltimore,72,3536000,49111.11111111111,52,2763000,53134.61538461538,20,773000
2018,county,48439,Tarrant,48021,Bastrop,TX,Austin,50,1049000,20980.0,36,1339000,37194.444444444445,14,-290000
2018,county,48113,Dallas,48021,Bastrop,TX,Austin,38,1170000,30789.473684210527,38,997000,26236.842105263157,0,173000
2018,county,48113,Dallas,12005,Bay,FL,FL Panhandle,53,1179000,22245.283018867925,45,1810000,40222.22222222222,8,-631000
2018,county,48439,Tarrant,48027,Bell,TX,Rural Texas,735,17625000,23979.591836734693,497,8377000,16855.13078470825,238,9248000
2018,county,48113,Dallas,48027,Bell,TX,Rural Texas,467,27464000,58809.421841541756,513,9563000,18641.325536062377,-46,17901000
2018,county,48121,Denton,48027,Bell,TX,Rural Texas,255,7771000,30474.50980392157,150,3581000,23873.333333333332,105,4190000
2018,county,48085,Collin,48027,Bell,TX,Rural Texas,230,6016000,26156.521739130436,141,4682000,33205.67375886525,89,1334000
2018,county,48439,Tarrant,05007,Benton,AR,Rural Arkansas,93,6774000,72838.70967741935,160,5770000,36062.5,-67,1004000
2018,county,48113,Dallas,05007,Benton,AR,Rural Arkansas,135,8183000,60614.81481481482,153,5270000,34444.444444444445,-18,2913000
2018,county,48121,Denton,05007,Benton,AR,Rural Arkansas,120,10855000,90458.33333333333,96,3819000,39781.25,24,7036000
2018,county,48085,Collin,05007,Benton,AR,Rural Arkansas,126,8270000,65634.92063492064,121,6339000,52388.42975206611,5,1931000
2018,county,48113,Dallas,34003,Bergen,NJ,New York,130,8240000,63384.61538461538,65,3315000,51000.0,65,4925000
2018,county,48085,Collin,34003,Bergen,NJ,New York,183,7059000,38573.770491803276,56,2898000,51750.0,127,4161000
2018,county,48439,Tarrant,35001,Bernalillo,NM,Albuquerque,227,6513000,28691.629955947137,112,3603000,32169.64285714286,115,2910000
2018,county,48113,Dallas,35001,Bernalillo,NM,Albuquerque,171,7465000,43654.97076023392,140,4968000,35485.71428571428,31,2497000
2018,county,48121,Denton,35001,Bernalillo,NM,Albuquerque,79,2564000,32455.696202531646,58,2002000,34517.24137931035,21,562000
2018,county,48085,Collin,35001,Bernalillo,NM,Albuquerque,145,8629000,59510.34482758621,43,2899000,67418.6046511628,102,5730000
2018,county,48439,Tarrant,48029,Bexar,TX,San Antonio,1235,38195000,30927.125506072876,1158,33798000,29186.528497409327,77,4397000
2018,county,48113,Dallas,48029,Bexar,TX,San Antonio,1555,53897000,34660.4501607717,1331,44960000,33779.11344853494,224,8937000
2018,county,48121,Denton,48029,Bexar,TX,San Antonio,580,19402000,33451.724137931036,419,14827000,35386.634844868735,161,4575000
2018,county,48085,Collin,48029,Bexar,TX,San Antonio,807,29583000,36657.99256505576,508,16837000,33143.700787401576,299,12746000
2018,county,48439,Tarrant,48035,Bosque,TX,Rural Texas,67,1726000,25761.194029850747,94,2677000,28478.72340425532,-27,-951000
2018,county,48439,Tarrant,22015,Bossier Parish,LA,Rural Louisiana,137,4069000,29700.729927007298,103,2480000,24077.66990291262,34,1589000
2018,county,48113,Dallas,22015,Bossier Parish,LA,Rural Louisiana,187,3787000,20251.336898395723,99,1401000,14151.515151515152,88,2386000
2018,county,48085,Collin,22015,Bossier Parish,LA,Rural Louisiana,98,2244000,22897.95918367347,41,1326000,32341.463414634145,57,918000
2018,county,48439,Tarrant,08013,Boulder,CO,Denver,38,1171000,30815.78947368421,82,4328000,52780.48780487805,-44,-3157000
2018,county,48113,Dallas,08013,Boulder,CO,Denver,45,1923000,42733.333333333336,69,2892000,41913.04347826087,-24,-969000
2018,county,48439,Tarrant,48037,Bowie,TX,Rural Texas,153,3232000,21124.183006535946,107,1811000,16925.233644859814,46,1421000
2018,county,48113,Dallas,48037,Bowie,TX,Rural Texas,184,4232000,23000.0,154,4080000,26493.506493506495,30,152000
2018,county,48121,Denton,48037,Bowie,TX,Rural Texas,61,1842000,30196.72131147541,51,1202000,23568.62745098039,10,640000
2018,county,48085,Collin,48037,Bowie,TX,Rural Texas,103,2229000,21640.776699029127,67,2158000,32208.955223880595,36,71000
2018,county,48439,Tarrant,48039,Brazoria,TX,Houston,148,4177000,28222.972972972973,157,4727000,30108.28025477707,-9,-550000
2018,county,48113,Dallas,48039,Brazoria,TX,Houston,155,5150000,33225.8064516129,125,3579000,28632.0,30,1571000
2018,county,48121,Denton,48039,Brazoria,TX,Houston,89,2978000,33460.67415730337,54,1806000,33444.444444444445,35,1172000
2018,county,48085,Collin,48039,Brazoria,TX,Houston,73,2440000,33424.65753424657,61,1918000,31442.622950819674,12,522000
2018,county,48439,Tarrant,48041,Brazos,TX,Rural Texas,269,7801000,29000.0,232,6506000,28043.103448275862,37,1295000
2018,county,48113,Dallas,48041,Brazos,TX,Rural Texas,330,8782000,26612.121212121212,218,6000000,27522.935779816515,112,2782000
2018,county,48121,Denton,48041,Brazos,TX,Rural Texas,137,4002000,29211.678832116788,100,2660000,26600.0,37,1342000
2018,county,48085,Collin,48041,Brazos,TX,Rural Texas,167,5404000,32359.28143712575,116,4361000,37594.8275862069,51,1043000
2018,county,48439,Tarrant,12009,Brevard,FL,Atlantic Coast,112,3104000,27714.285714285714,88,5144000,58454.545454545456,24,-2040000
2018,county,48113,Dallas,12009,Brevard,FL,Atlantic Coast,68,2901000,42661.76470588235,51,1954000,38313.72549019608,17,947000
2018,county,48085,Collin,12009,Brevard,FL,Atlantic Coast,49,1775000,36224.489795918365,61,3420000,56065.57377049181,-12,-1645000
2018,county,48439,Tarrant,36005,Bronx,NY,New York,114,2360000,20701.754385964912,45,621000,13800.0,69,1739000
2018,county,48113,Dallas,36005,Bronx,NY,New York,123,2265000,18414.634146341465,47,971000,20659.574468085106,76,1294000
2018,county,48439,Tarrant,12011,Broward,FL,Miami,268,7056000,26328.358208955226,149,5555000,37281.87919463087,119,1501000
2018,county,48113,Dallas,12011,Broward,FL,Miami,346,14797000,42765.89595375722,276,16529000,59887.68115942029,70,-1732000
2018,county,48121,Denton,12011,Broward,FL,Miami,144,9982000,69319.44444444444,98,4265000,43520.4081632653,46,5717000
2018,county,48085,Collin,12011,Broward,FL,Miami,309,12952000,41915.857605178,126,6935000,55039.68253968254,183,6017000
2018,county,48439,Tarrant,48049,Brown,TX,Rural Texas,75,1376000,18346.666666666668,68,1281000,18838.235294117647,7,95000
2018,county,48113,Dallas,40013,Bryan,OK,Rural Oklahoma,44,1573000,35750.0,64,1071000,16734.375,-20,502000
2018,county,48085,Collin,40013,Bryan,OK,Rural Oklahoma,75,1955000,26066.666666666668,59,1883000,31915.254237288136,16,72000
2018,county,48439,Tarrant,22017,Caddo Parish,LA,Rural Louisiana,433,6851000,15822.170900692841,196,2956000,15081.632653061224,237,3895000
2018,county,48113,Dallas,22017,Caddo Parish,LA,Rural Louisiana,635,10362000,16318.110236220473,287,5480000,19094.076655052264,348,4882000
2018,county,48121,Denton,22017,Caddo Parish,LA,Rural Louisiana,160,2678000,16737.5,71,1297000,18267.605633802817,89,1381000
2018,county,48085,Collin,22017,Caddo Parish,LA,Rural Louisiana,199,4467000,22447.23618090452,52,1674000,32192.30769230769,147,2793000
2018,county,48439,Tarrant,22019,Calcasieu Parish,LA,Rural Louisiana,57,1435000,25175.43859649123,58,970000,16724.137931034482,-1,465000
2018,county,48113,Dallas,22019,Calcasieu Parish,LA,Rural Louisiana,69,956000,13855.072463768116,40,827000,20675.0,29,129000
2018,county,48439,Tarrant,48061,Cameron,TX,Rural Texas,197,3033000,15395.939086294416,135,2893000,21429.62962962963,62,140000
2018,county,48113,Dallas,48061,Cameron,TX,Rural Texas,205,4668000,22770.731707317074,201,4016000,19980.099502487563,4,652000
2018,county,48121,Denton,48061,Cameron,TX,Rural Texas,75,1475000,19666.666666666668,53,1629000,30735.849056603773,22,-154000
2018,county,48085,Collin,48061,Cameron,TX,Rural Texas,56,1433000,25589.285714285714,49,761000,15530.612244897959,7,672000
2018,county,48439,Tarrant,40017,Canadian,OK,Oklahoma City,100,4353000,43530.0,82,2824000,34439.0243902439,18,1529000
2018,county,48113,Dallas,40017,Canadian,OK,Oklahoma City,55,1263000,22963.636363636364,34,1038000,30529.41176470588,21,225000
2018,county,48121,Denton,40017,Canadian,OK,Oklahoma City,70,2474000,35342.857142857145,51,1500000,29411.764705882353,19,974000
2018,county,48439,Tarrant,40019,Carter,OK,Rural Oklahoma,50,1087000,21740.0,37,748000,20216.216216216217,13,339000
2018,county,48439,Tarrant,45019,Charleston,SC,Charleston,48,1354000,28208.333333333332,74,4548000,61459.45945945946,-26,-3194000
2018,county,48113,Dallas,45019,Charleston,SC,Charleston,49,2230000,45510.204081632655,39,3820000,97948.71794871795,10,-1590000
2018,county,48439,Tarrant,13051,Chatham,GA,Savannah,36,1240000,34444.444444444445,44,1163000,26431.81818181818,-8,77000
2018,county,48113,Dallas,13051,Chatham,GA,Savannah,54,1634000,30259.25925925926,44,1808000,41090.90909090909,10,-174000
2018,county,48439,Tarrant,48073,Cherokee,TX,Rural Texas,42,803000,19119.04761904762,79,1108000,14025.316455696202,-37,-305000
2018,county,48113,Dallas,48073,Cherokee,TX,Rural Texas,56,1112000,19857.14285714286,61,1744000,28590.16393442623,-5,-632000
2018,county,48113,Dallas,42029,Chester,PA,Philadelphia,50,2321000,46420.0,52,2843000,54673.07692307692,-2,-522000
2018,county,48085,Collin,42029,Chester,PA,Philadelphia,68,4097000,60250.0,55,2498000,45418.181818181816,13,1599000
2018,county,48439,Tarrant,32003,Clark,NV,Las Vegas,483,15190000,31449.27536231884,368,12262000,33320.65217391304,115,2928000
2018,county,48439,Tarrant,53011,Clark,WA,Portland,60,1849000,30816.666666666668,70,3142000,44885.71428571428,-10,-1293000
2018,county,48113,Dallas,32003,Clark,NV,Las Vegas,474,12983000,27390.29535864979,425,21676000,51002.35294117647,49,-8693000
2018,county,48113,Dallas,53011,Clark,WA,Portland,65,3063000,47123.07692307692,40,1756000,43900.0,25,1307000
2018,county,48121,Denton,32003,Clark,NV,Las Vegas,212,8606000,40594.339622641506,174,7297000,41936.7816091954,38,1309000
2018,county,48121,Denton,53011,Clark,WA,Portland,52,2693000,51788.46153846154,41,1486000,36243.90243902439,11,1207000
2018,county,48085,Collin,32003,Clark,NV,Las Vegas,273,10607000,38853.479853479854,212,8500000,40094.339622641506,61,2107000
2018,county,48439,Tarrant,29047,Clay,MO,Kansas City,79,3398000,43012.6582278481,73,2206000,30219.178082191782,6,1192000
2018,county,48439,Tarrant,13063,Clayton,GA,Atlanta,37,732000,19783.783783783783,39,429000,11000.0,-2,303000
2018,county,48113,Dallas,13063,Clayton,GA,Atlanta,68,1246000,18323.529411764706,60,836000,13933.333333333334,8,410000
2018,county,48439,Tarrant,40027,Cleveland,OK,Oklahoma City,168,4708000,28023.809523809523,177,5204000,29401.129943502823,-9,-496000
2018,county,48113,Dallas,40027,Cleveland,OK,Oklahoma City,154,5313000,34500.0,120,4472000,37266.666666666664,34,841000
2018,county,48121,Denton,40027,Cleveland,OK,Oklahoma City,98,2605000,26581.632653061224,94,2357000,25074.468085106382,4,248000
2018,county,48085,Collin,40027,Cleveland,OK,Oklahoma City,116,3113000,26836.206896551725,99,3492000,35272.72727272727,17,-379000
2018,county,48439,Tarrant,13067,Cobb,GA,Atlanta,173,6771000,39138.72832369942,118,3834000,32491.525423728814,55,2937000
2018,county,48113,Dallas,13067,Cobb,GA,Atlanta,212,9859000,46504.71698113208,163,5470000,33558.28220858896,49,4389000
2018,county,48121,Denton,13067,Cobb,GA,Atlanta,103,3454000,33533.98058252427,56,2423000,43267.857142857145,47,1031000
2018,county,48085,Collin,13067,Cobb,GA,Atlanta,122,7044000,57737.70491803279,65,2770000,42615.38461538462,57,4274000
2018,county,48439,Tarrant,12021,Collier,FL,S.W. Florida,36,1917000,53250.0,49,4580000,93469.38775510204,-13,-2663000
2018,county,48113,Dallas,12021,Collier,FL,S.W. Florida,40,1682000,42050.0,54,8344000,154518.5185185185,-14,-6662000
2018,county,48439,Tarrant,48085,Collin,TX,Dallas-Fort Worth,2560,94294000,36833.59375,3377,119014000,35242.52294936334,-817,-24720000
2018,county,48113,Dallas,48085,Collin,TX,Dallas-Fort Worth,15187,817519000,53830.183709751764,23299,875753000,37587.578866045755,-8112,-58234000
2018,county,48121,Denton,48085,Collin,TX,Dallas-Fort Worth,11953,516573000,43217.01664854011,11670,567160000,48599.828620394175,283,-50587000
2018,county,48439,Tarrant,48091,Comal,TX,San Antonio,84,2980000,35476.19047619047,129,5095000,39496.124031007756,-45,-2115000
2018,county,48113,Dallas,48091,Comal,TX,San Antonio,91,4298000,47230.769230769234,115,7578000,65895.65217391304,-24,-3280000
2018,county,48121,Denton,48091,Comal,TX,San Antonio,49,1597000,32591.836734693876,67,3483000,51985.07462686567,-18,-1886000
2018,county,48085,Collin,48091,Comal,TX,San Antonio,39,1745000,44743.58974358974,144,8037000,55812.5,-105,-6292000
2018,county,48439,Tarrant,40031,Comanche,OK,Rural Oklahoma,129,2904000,22511.627906976744,95,1771000,18642.105263157893,34,1133000
2018,county,48113,Dallas,40031,Comanche,OK,Rural Oklahoma,134,2386000,17805.97014925373,83,1818000,21903.614457831325,51,568000
2018,county,48121,Denton,40031,Comanche,OK,Rural Oklahoma,54,1603000,29685.185185185186,50,755000,15100.0,4,848000
2018,county,48439,Tarrant,06013,Contra Costa,CA,Bay Area,195,11906000,61056.41025641026,97,3707000,38216.49484536082,98,8199000
2018,county,48113,Dallas,06013,Contra Costa,CA,Bay Area,137,9847000,71875.91240875912,144,8556000,59416.666666666664,-7,1291000
2018,county,48121,Denton,06013,Contra Costa,CA,Bay Area,94,4203000,44712.765957446805,51,2504000,49098.03921568627,43,1699000
2018,county,48085,Collin,06013,Contra Costa,CA,Bay Area,169,11804000,69846.15384615384,79,3190000,40379.74683544304,90,8614000
2018,county,48439,Tarrant,17031,Cook,IL,Chicago,734,38823000,52892.37057220708,479,15005000,31325.678496868477,255,23818000
2018,county,48113,Dallas,17031,Cook,IL,Chicago,1310,73829000,56358.01526717557,704,36880000,52386.36363636364,606,36949000
2018,county,48121,Denton,17031,Cook,IL,Chicago,395,20396000,51635.443037974685,181,5547000,30646.408839779004,214,14849000
2018,county,48085,Collin,17031,Cook,IL,Chicago,700,29084000,41548.57142857143,306,12774000,41745.098039215685,394,16310000
2018,county,48439,Tarrant,48097,Cooke,TX,Rural Texas,80,1647000,20587.5,132,5325000,40340.90909090909,-52,-3678000
2018,county,48113,Dallas,48097,Cooke,TX,Rural Texas,59,2027000,34355.93220338983,102,2783000,27284.313725490196,-43,-756000
2018,county,48121,Denton,48097,Cooke,TX,Rural Texas,465,12823000,27576.344086021505,896,35155000,39235.49107142857,-431,-22332000
2018,county,48085,Collin,48097,Cooke,TX,Rural Texas,73,2726000,37342.46575342466,162,9525000,58796.2962962963,-89,-6799000
2018,county,48439,Tarrant,48099,Coryell,TX,Rural Texas,103,1890000,18349.514563106797,70,1380000,19714.285714285714,33,510000
2018,county,48113,Dallas,48099,Coryell,TX,Rural Texas,80,1568000,19600.0,56,982000,17535.714285714286,24,586000
2018,county,48439,Tarrant,37051,Cumberland,NC,Rural North Carolina,101,1604000,15881.18811881188,58,1059000,18258.620689655174,43,545000
2018,county,48113,Dallas,37051,Cumberland,NC,Rural North Carolina,68,1129000,16602.941176470587,57,848000,14877.192982456141,11,281000
2018,county,48439,Tarrant,39035,Cuyahoga,OH,Cleveland,86,4054000,47139.53488372093,75,2595000,34600.0,11,1459000
2018,county,48113,Dallas,39035,Cuyahoga,OH,Cleveland,146,8710000,59657.53424657534,115,6340000,55130.434782608696,31,2370000
2018,county,48085,Collin,39035,Cuyahoga,OH,Cleveland,85,3543000,41682.35294117647,45,1852000,41155.555555555555,40,1691000
2018,county,48439,Tarrant,27037,Dakota,MN,Minneapolis,54,2765000,51203.7037037037,70,1761000,25157.14285714286,-16,1004000
2018,county,48113,Dallas,27037,Dakota,MN,Minneapolis,48,1978000,41208.333333333336,52,1477000,28403.846153846152,-4,501000
2018,county,48439,Tarrant,48113,Dallas,TX,Dallas-Fort Worth,24884,684877000,27522.78572576756,19943,554900000,27824.29925287068,4941,129977000
2018,county,48121,Denton,48113,Dallas,TX,Dallas-Fort Worth,16617,581098000,34970.09087079497,10991,379374000,34516.786461650445,5626,201724000
2018,county,48085,Collin,48113,Dallas,TX,Dallas-Fort Worth,23299,875753000,37587.578866045755,15187,817519000,53830.183709751764,8112,58234000
2018,county,48439,Tarrant,55025,Dane,WI,Madison,43,1730000,40232.558139534885,64,1685000,26328.125,-21,45000
2018,county,48113,Dallas,55025,Dane,WI,Madison,85,3061000,36011.76470588235,59,2638000,44711.86440677966,26,423000
2018,county,48085,Collin,55025,Dane,WI,Madison,68,2971000,43691.17647058824,48,1604000,33416.666666666664,20,1367000
2018,county,48439,Tarrant,47037,Davidson,TN,Nashville,118,3755000,31822.033898305086,125,4938000,39504.0,-7,-1183000
2018,county,48113,Dallas,47037,Davidson,TN,Nashville,293,15452000,52737.20136518771,306,20727000,67735.29411764706,-13,-5275000
2018,county,48121,Denton,47037,Davidson,TN,Nashville,50,3304000,66080.0,56,2305000,41160.71428571428,-6,999000
2018,county,48085,Collin,47037,Davidson,TN,Nashville,88,2920000,33181.818181818184,99,4115000,41565.656565656565,-11,-1195000
2018,county,48439,Tarrant,49011,Davis,UT,Rural Utah,60,1199000,19983.333333333332,59,2977000,50457.627118644064,1,-1778000
2018,county,48439,Tarrant,13089,DeKalb,GA,Atlanta,135,4525000,33518.51851851852,107,2762000,25813.084112149532,28,1763000
2018,county,48113,Dallas,13089,DeKalb,GA,Atlanta,249,9954000,39975.903614457835,243,11244000,46271.60493827161,6,-1290000
2018,county,48121,Denton,13089,DeKalb,GA,Atlanta,57,2844000,49894.73684210526,38,1642000,43210.52631578947,19,1202000
2018,county,48085,Collin,13089,DeKalb,GA,Atlanta,87,3012000,34620.68965517241,60,1882000,31366.666666666668,27,1130000
2018,county,48113,Dallas,28033,DeSoto,MS,Memphis,47,1069000,22744.68085106383,64,1954000,30531.25,-17,-885000
2018,county,48439,Tarrant,48121,Denton,TX,Dallas-Fort Worth,7614,286288000,37600.21013921723,9238,392039000,42437.648841740636,-1624,-105751000
2018,county,48113,Dallas,48121,Denton,TX,Dallas-Fort Worth,10991,379374000,34516.786461650445,16617,581098000,34970.09087079497,-5626,-201724000
2018,county,48085,Collin,48121,Denton,TX,Dallas-Fort Worth,11670,567160000,48599.828620394175,11953,516573000,43217.01664854011,-283,50587000
2018,county,48439,Tarrant,08031,Denver,CO,Denver,158,7582000,47987.3417721519,204,9671000,47406.86274509804,-46,-2089000
2018,county,48113,Dallas,08031,Denver,CO,Denver,286,16263000,56863.63636363636,468,31376000,67042.73504273505,-182,-15113000
2018,county,48121,Denton,08031,Denver,CO,Denver,84,4118000,49023.80952380953,100,6451000,64510.0,-16,-2333000
2018,county,48085,Collin,08031,Denver,CO,Denver,115,4680000,40695.65217391304,149,8425000,56543.62416107383,-34,-3745000
2018,county,48439,Tarrant,11001,District of Columbia,DC,D.C.,53,3744000,70641.50943396226,74,3390000,45810.81081081081,-21,354000
2018,county,48113,Dallas,11001,District of Columbia,DC,D.C.,143,9490000,66363.63636363637,153,11312000,73934.64052287582,-10,-1822000
2018,county,48085,Collin,11001,District of Columbia,DC,D.C.,38,2003000,52710.52631578947,45,2992000,66488.88888888889,-7,-989000
2018,county,48439,Tarrant,35013,Dona Ana,NM,Rural New Mexico,61,1798000,29475.409836065573,63,1015000,16111.111111111111,-2,783000
2018,county,48113,Dallas,35013,Dona Ana,NM,Rural New Mexico,58,1996000,34413.793103448275,49,1489000,30387.755102040817,9,507000
2018,county,48439,Tarrant,31055,Douglas,NE,Omaha,130,3531000,27161.53846153846,129,3555000,27558.13953488372,1,-24000
2018,county,48439,Tarrant,08035,Douglas,CO,Denver,117,6859000,58623.931623931625,147,9193000,62537.4149659864,-30,-2334000
2018,county,48113,Dallas,31055,Douglas,NE,Omaha,150,4304000,28693.333333333332,104,2663000,25605.76923076923,46,1641000
2018,county,48113,Dallas,08035,Douglas,CO,Denver,103,5329000,51737.8640776699,144,12182000,84597.22222222222,-41,-6853000
2018,county,48121,Denton,08035,Douglas,CO,Denver,121,6217000,51380.1652892562,101,5821000,57633.66336633663,20,396000
2018,county,48121,Denton,31055,Douglas,NE,Omaha,73,4985000,68287.67123287672,62,1859000,29983.870967741936,11,3126000
2018,county,48085,Collin,08035,Douglas,CO,Denver,151,7264000,48105.96026490066,159,8998000,56591.19496855346,-8,-1734000
2018,county,48085,Collin,31055,Douglas,NE,Omaha,121,5248000,43371.90082644628,66,2680000,40606.06060606061,55,2568000
2018,county,48439,Tarrant,17043,DuPage,IL,Chicago,146,8877000,60801.3698630137,80,4714000,58925.0,66,4163000
2018,county,48113,Dallas,17043,DuPage,IL,Chicago,199,10301000,51763.81909547739,130,6767000,52053.846153846156,69,3534000
2018,county,48121,Denton,17043,DuPage,IL,Chicago,115,6268000,54504.34782608696,44,1673000,38022.72727272727,71,4595000
2018,county,48085,Collin,17043,DuPage,IL,Chicago,307,18568000,60482.08469055375,113,4183000,37017.69911504425,194,14385000
2018,county,48439,Tarrant,37063,Durham,NC,Raleigh,51,1428000,28000.0,45,1379000,30644.444444444445,6,49000
2018,county,48113,Dallas,37063,Durham,NC,Raleigh,64,2944000,46000.0,40,1603000,40075.0,24,1341000
2018,county,48439,Tarrant,12031,Duval,FL,Jacksonville,162,4816000,29728.395061728395,142,4132000,29098.591549295776,20,684000
2018,county,48113,Dallas,12031,Duval,FL,Jacksonville,215,8372000,38939.53488372093,197,10238000,51969.543147208125,18,-1866000
2018,county,48121,Denton,12031,Duval,FL,Jacksonville,62,1971000,31790.322580645163,62,2585000,41693.54838709677,0,-614000
2018,county,48085,Collin,12031,Duval,FL,Jacksonville,101,4845000,47970.29702970297,85,3330000,39176.470588235294,16,1515000
2018,county,48439,Tarrant,22033,East Baton Rouge Parish,LA,Rural Louisiana,171,2938000,17181.2865497076,120,2237000,18641.666666666668,51,701000
2018,county,48113,Dallas,22033,East Baton Rouge Parish,LA,Rural Louisiana,206,5668000,27514.563106796115,131,3275000,25000.0,75,2393000
2018,county,48121,Denton,22033,East Baton Rouge Parish,LA,Rural Louisiana,93,2587000,27817.204301075268,40,776000,19400.0,53,1811000
2018,county,48085,Collin,22033,East Baton Rouge Parish,LA,Rural Louisiana,106,3113000,29367.924528301886,37,1355000,36621.62162162162,69,1758000
2018,county,48439,Tarrant,48133,Eastland,TX,Rural Texas,32,644000,20125.0,46,1343000,29195.652173913044,-14,-699000
2018,county,48439,Tarrant,48135,Ector,TX,Rural Texas,204,4807000,23563.725490196077,218,5040000,23119.26605504587,-14,-233000
2018,county,48113,Dallas,48135,Ector,TX,Rural Texas,165,3780000,22909.090909090908,201,4426000,22019.900497512437,-36,-646000
2018,county,48121,Denton,48135,Ector,TX,Rural Texas,64,1999000,31234.375,69,2687000,38942.02898550725,-5,-688000
2018,county,48085,Collin,48135,Ector,TX,Rural Texas,54,2118000,39222.22222222222,29,993000,34241.379310344826,25,1125000
2018,county,48439,Tarrant,48141,El Paso,TX,El Paso,614,14307000,23301.302931596092,414,9102000,21985.507246376812,200,5205000
2018,county,48439,Tarrant,08041,El Paso,CO,Colorado Springs,265,6023000,22728.30188679245,354,16766000,47361.581920903955,-89,-10743000
2018,county,48113,Dallas,48141,El Paso,TX,El Paso,520,13492000,25946.153846153848,455,10304000,22646.153846153848,65,3188000
2018,county,48113,Dallas,08041,El Paso,CO,Colorado Springs,195,5778000,29630.76923076923,308,10825000,35146.103896103894,-113,-5047000
2018,county,48121,Denton,48141,El Paso,TX,El Paso,194,4214000,21721.649484536083,138,4369000,31659.420289855072,56,-155000
2018,county,48121,Denton,08041,El Paso,CO,Colorado Springs,188,5518000,29351.063829787236,184,5612000,30500.0,4,-94000
2018,county,48085,Collin,48141,El Paso,TX,El Paso,286,10465000,36590.90909090909,177,4688000,26485.87570621469,109,5777000
2018,county,48085,Collin,08041,El Paso,CO,Colorado Springs,162,5207000,32141.975308641977,195,6204000,31815.384615384617,-33,-997000
2018,county,48439,Tarrant,48139,Ellis,TX,Dallas-Fort Worth,1229,46189000,37582.587469487386,2419,91040000,37635.386523356756,-1190,-44851000
2018,county,48113,Dallas,48139,Ellis,TX,Dallas-Fort Worth,2542,61844000,24328.87490165224,5235,137351000,26237.058261700095,-2693,-75507000
2018,county,48121,Denton,48139,Ellis,TX,Dallas-Fort Worth,278,9008000,32402.877697841726,376,10953000,29130.31914893617,-98,-1945000
2018,county,48085,Collin,48139,Ellis,TX,Dallas-Fort Worth,235,8148000,34672.34042553192,355,11733000,33050.704225352114,-120,-3585000
2018,county,48439,Tarrant,48143,Erath,TX,Rural Texas,189,5315000,28121.693121693123,239,3610000,15104.60251046025,-50,1705000
2018,county,48113,Dallas,48143,Erath,TX,Rural Texas,41,949000,23146.341463414636,52,985000,18942.30769230769,-11,-36000
2018,county,48113,Dallas,36029,Erie,NY,Buffalo,66,1717000,26015.151515151516,51,895000,17549.019607843136,15,822000
2018,county,48439,Tarrant,12033,Escambia,FL,FL Panhandle,107,1972000,18429.906542056076,77,2708000,35168.831168831166,30,-736000
2018,county,48113,Dallas,12033,Escambia,FL,FL Panhandle,66,2639000,39984.84848484849,46,1191000,25891.304347826088,20,1448000
2018,county,48439,Tarrant,34013,Essex,NJ,New York,45,1314000,29200.0,47,3032000,64510.63829787234,-2,-1718000
2018,county,48113,Dallas,34013,Essex,NJ,New York,82,3284000,40048.78048780488,29,1257000,43344.8275862069,53,2027000
2018,county,48439,Tarrant,51059,Fairfax,VA,D.C.,190,7782000,40957.89473684211,150,8773000,58486.666666666664,40,-991000
2018,county,48113,Dallas,51059,Fairfax,VA,D.C.,276,11123000,40300.72463768116,244,15311000,62750.0,32,-4188000
2018,county,48121,Denton,51059,Fairfax,VA,D.C.,131,6805000,51946.564885496184,81,3887000,47987.654320987655,50,2918000
2018,county,48085,Collin,51059,Fairfax,VA,D.C.,243,12115000,49855.9670781893,238,10408000,43731.09243697479,5,1707000
2018,county,48439,Tarrant,09001,Fairfield,CT,New York,94,5410000,57553.1914893617,55,3475000,63181.818181818184,39,1935000
2018,county,48113,Dallas,09001,Fairfield,CT,New York,199,31801000,159804.0201005025,99,17063000,172353.53535353535,100,14738000
2018,county,48121,Denton,09001,Fairfield,CT,New York,80,6384000,79800.0,54,3525000,65277.77777777778,26,2859000
2018,county,48085,Collin,09001,Fairfield,CT,New York,104,6104000,58692.307692307695,61,3325000,54508.19672131148,43,2779000
2018,county,48439,Tarrant,48147,Fannin,TX,Rural Texas,74,1866000,25216.216216216217,74,1409000,19040.54054054054,0,457000
2018,county,48113,Dallas,48147,Fannin,TX,Rural Texas,87,1944000,22344.827586206895,173,3966000,22924.85549132948,-86,-2022000
2018,county,48121,Denton,48147,Fannin,TX,Rural Texas,65,1609000,24753.846153846152,124,3395000,27379.032258064515,-59,-1786000
2018,county,48085,Collin,48147,Fannin,TX,Rural Texas,237,8286000,34962.0253164557,613,17152000,27980.42414355628,-376,-8866000
2018,county,48113,Dallas,37067,Forsyth,NC,Greensboro,48,1687000,35145.833333333336,45,1894000,42088.88888888889,3,-207000
2018,county,48113,Dallas,13117,Forsyth,GA,Atlanta,51,2360000,46274.509803921566,46,2029000,44108.69565217391,5,331000
2018,county,48439,Tarrant,48157,Fort Bend,TX,Houston,355,14157000,39878.873239436616,334,12734000,38125.748502994014,21,1423000
2018,county,48113,Dallas,48157,Fort Bend,TX,Houston,461,19921000,43212.581344902384,384,16516000,43010.416666666664,77,3405000
2018,county,48121,Denton,48157,Fort Bend,TX,Houston,258,12929000,50112.40310077519,186,7096000,38150.5376344086,72,5833000
2018,county,48085,Collin,48157,Fort Bend,TX,Houston,442,18005000,40735.294117647056,271,13231000,48822.87822878229,171,4774000
2018,county,48439,Tarrant,39049,Franklin,OH,Columbus,135,3571000,26451.85185185185,224,4454000,19883.928571428572,-89,-883000
2018,county,48113,Dallas,39049,Franklin,OH,Columbus,225,9218000,40968.88888888889,189,6732000,35619.04761904762,36,2486000
2018,county,48121,Denton,39049,Franklin,OH,Columbus,112,6052000,54035.71428571428,70,4160000,59428.57142857143,42,1892000
2018,county,48085,Collin,39049,Franklin,OH,Columbus,153,9188000,60052.28758169935,101,5442000,53881.18811881188,52,3746000
2018,county,48113,Dallas,48161,Freestone,TX,Rural Texas,46,588000,12782.608695652174,48,652000,13583.333333333334,-2,-64000
2018,county,48439,Tarrant,06019,Fresno,CA,Fresno,117,3127000,26726.495726495727,69,1232000,17855.072463768116,48,1895000
2018,county,48113,Dallas,06019,Fresno,CA,Fresno,115,2004000,17426.08695652174,77,1287000,16714.285714285714,38,717000
2018,county,48439,Tarrant,13121,Fulton,GA,Atlanta,174,7666000,44057.471264367814,176,9293000,52801.13636363636,-2,-1627000
2018,county,48113,Dallas,13121,Fulton,GA,Atlanta,378,29914000,79137.56613756614,368,21403000,58160.32608695652,10,8511000
2018,county,48121,Denton,13121,Fulton,GA,Atlanta,101,6765000,66980.19801980197,95,4992000,52547.36842105263,6,1773000
2018,county,48085,Collin,13121,Fulton,GA,Atlanta,244,13668000,56016.39344262295,188,9895000,52632.97872340425,56,3773000
2018,county,48439,Tarrant,48167,Galveston,TX,Houston,161,4942000,30695.652173913044,190,5737000,30194.736842105263,-29,-795000
2018,county,48113,Dallas,48167,Galveston,TX,Houston,180,6433000,35738.88888888889,215,7459000,34693.023255813954,-35,-1026000
2018,county,48121,Denton,48167,Galveston,TX,Houston,81,2915000,35987.654320987655,94,3823000,40670.21276595745,-13,-908000
2018,county,48085,Collin,48167,Galveston,TX,Houston,83,2984000,35951.80722891566,94,3645000,38776.59574468085,-11,-661000
2018,county,48439,Tarrant,05051,Garland,AR,Rural Arkansas,49,1090000,22244.897959183672,60,2266000,37766.666666666664,-11,-1176000
2018,county,48439,Tarrant,26049,Genesee,MI,Rural Michigan,119,2010000,16890.756302521007,68,1016000,14941.176470588236,51,994000
2018,county,48113,Dallas,26049,Genesee,MI,Rural Michigan,36,547000,15194.444444444445,47,1366000,29063.82978723404,-11,-819000
2018,county,48439,Tarrant,48181,Grayson,TX,Rural Texas,251,4919000,19597.609561752986,286,8172000,28573.426573426572,-35,-3253000
2018,county,48113,Dallas,48181,Grayson,TX,Rural Texas,362,10308000,28475.138121546963,599,27254000,45499.1652754591,-237,-16946000
2018,county,48121,Denton,48181,Grayson,TX,Rural Texas,443,12337000,27848.758465011288,850,26837000,31572.941176470587,-407,-14500000
2018,county,48085,Collin,48181,Grayson,TX,Rural Texas,938,31901000,34009.59488272921,1974,60835000,30818.135764944276,-1036,-28934000
2018,county,48439,Tarrant,29077,Greene,MO,Rural Missouri,53,1073000,20245.283018867925,63,1270000,20158.73015873016,-10,-197000
2018,county,48113,Dallas,29077,Greene,MO,Rural Missouri,42,1273000,30309.52380952381,43,1833000,42627.90697674418,-1,-560000
2018,county,48439,Tarrant,45045,Greenville,SC,Greenville,41,1907000,46512.19512195122,68,2760000,40588.23529411765,-27,-853000
2018,county,48113,Dallas,45045,Greenville,SC,Greenville,79,4012000,50784.81012658228,74,4626000,62513.51351351351,5,-614000
2018,county,48439,Tarrant,48183,Gregg,TX,Rural Texas,221,6261000,28330.31674208145,192,4728000,24625.0,29,1533000
2018,county,48113,Dallas,48183,Gregg,TX,Rural Texas,370,8927000,24127.027027027027,296,5926000,20020.27027027027,74,3001000
2018,county,48121,Denton,48183,Gregg,TX,Rural Texas,72,1966000,27305.555555555555,90,1991000,22122.222222222223,-18,-25000
2018,county,48085,Collin,48183,Gregg,TX,Rural Texas,135,4205000,31148.14814814815,77,2235000,29025.974025974025,58,1970000
2018,county,48439,Tarrant,48187,Guadalupe,TX,San Antonio,126,3201000,25404.761904761905,119,3631000,30512.605042016807,7,-430000
2018,county,48113,Dallas,48187,Guadalupe,TX,San Antonio,84,1841000,21916.666666666668,80,2260000,28250.0,4,-419000
2018,county,48121,Denton,48187,Guadalupe,TX,San Antonio,71,2658000,37436.619718309856,49,1694000,34571.42857142857,22,964000
2018,county,48085,Collin,48187,Guadalupe,TX,San Antonio,47,1461000,31085.106382978724,61,1430000,23442.622950819674,-14,31000
2018,county,48439,Tarrant,37081,Guilford,NC,Greensboro,55,1378000,25054.545454545456,52,2166000,41653.846153846156,3,-788000
2018,county,48113,Dallas,37081,Guilford,NC,Greensboro,64,1516000,23687.5,49,1078000,22000.0,15,438000
2018,county,48439,Tarrant,13135,Gwinnett,GA,Atlanta,133,3426000,25759.398496240603,98,2910000,29693.877551020407,35,516000
2018,county,48113,Dallas,13135,Gwinnett,GA,Atlanta,162,4641000,28648.14814814815,166,4078000,24566.265060240963,-4,563000
2018,county,48121,Denton,13135,Gwinnett,GA,Atlanta,112,3137000,28008.928571428572,72,2703000,37541.666666666664,40,434000
2018,county,48085,Collin,13135,Gwinnett,GA,Atlanta,101,3552000,35168.316831683165,112,3165000,28258.928571428572,-11,387000
2018,county,48439,Tarrant,39061,Hamilton,OH,Cincinnati,55,2273000,41327.27272727273,108,2740000,25370.37037037037,-53,-467000
2018,county,48113,Dallas,39061,Hamilton,OH,Cincinnati,102,4780000,46862.74509803922,122,3776000,30950.819672131147,-20,1004000
2018,county,48113,Dallas,47065,Hamilton,TN,Chattanooga,55,1607000,29218.18181818182,39,1824000,46769.230769230766,16,-217000
2018,county,48121,Denton,18057,Hamilton,IN,Indianapolis,71,4003000,56380.281690140844,65,2560000,39384.61538461538,6,1443000
2018,county,48439,Tarrant,48201,Harris,TX,Houston,2390,84280000,35263.59832635983,2193,79595000,36295.029639762884,197,4685000
2018,county,48113,Dallas,48201,Harris,TX,Houston,3714,170777000,45981.96015078083,3076,125011000,40640.76723016905,638,45766000
2018,county,48121,Denton,48201,Harris,TX,Houston,1076,43903000,40802.04460966543,736,24145000,32805.70652173913,340,19758000
2018,county,48085,Collin,48201,Harris,TX,Houston,1409,66373000,47106.458481192334,937,37128000,39624.33297758805,472,29245000
2018,county,48439,Tarrant,48203,Harrison,TX,Rural Texas,110,2547000,23154.545454545456,87,2670000,30689.655172413793,23,-123000
2018,county,48439,Tarrant,28047,Harrison,MS,Gulfport-Biloxi,62,1043000,16822.58064516129,43,888000,20651.162790697676,19,155000
2018,county,48113,Dallas,48203,Harrison,TX,Rural Texas,153,2556000,16705.882352941175,136,2070000,15220.588235294117,17,486000
2018,county,48121,Denton,48203,Harrison,TX,Rural Texas,32,727000,22718.75,49,1545000,31530.61224489796,-17,-818000
2018,county,48439,Tarrant,09003,Hartford,CT,Hartford,45,1704000,37866.666666666664,60,1657000,27616.666666666668,-15,47000
2018,county,48113,Dallas,09003,Hartford,CT,Hartford,118,5928000,50237.28813559322,48,2403000,50062.5,70,3525000
2018,county,48085,Collin,09003,Hartford,CT,Hartford,110,4153000,37754.545454545456,51,1793000,35156.86274509804,59,2360000
2018,county,48439,Tarrant,48209,Hays,TX,Austin,175,4571000,26120.0,185,6656000,35978.37837837838,-10,-2085000
2018,county,48113,Dallas,48209,Hays,TX,Austin,142,4184000,29464.788732394365,192,9791000,50994.791666666664,-50,-5607000
2018,county,48121,Denton,48209,Hays,TX,Austin,110,3883000,35300.0,107,4076000,38093.457943925234,3,-193000
2018,county,48085,Collin,48209,Hays,TX,Austin,100,2784000,27840.0,117,4785000,40897.4358974359,-17,-2001000
2018,county,48439,Tarrant,48213,Henderson,TX,Rural Texas,191,4482000,23465.968586387433,283,8649000,30561.837455830388,-92,-4167000
2018,county,48113,Dallas,48213,Henderson,TX,Rural Texas,338,9203000,27227.810650887575,678,23970000,35353.982300884956,-340,-14767000
2018,county,48121,Denton,48213,Henderson,TX,Rural Texas,70,2097000,29957.14285714286,118,9891000,83822.03389830509,-48,-7794000
2018,county,48085,Collin,48213,Henderson,TX,Rural Texas,92,3737000,40619.565217391304,125,6965000,55720.0,-33,-3228000
2018,county,48439,Tarrant,27053,Hennepin,MN,Minneapolis,151,7917000,52430.46357615894,152,4445000,29243.42105263158,-1,3472000
2018,county,48113,Dallas,27053,Hennepin,MN,Minneapolis,289,12927000,44730.10380622838,204,10766000,52774.509803921566,85,2161000
2018,county,48121,Denton,27053,Hennepin,MN,Minneapolis,97,9110000,93917.52577319587,90,4068000,45200.0,7,5042000
2018,county,48085,Collin,27053,Hennepin,MN,Minneapolis,230,20254000,88060.86956521739,123,5509000,44788.617886178865,107,14745000
2018,county,48113,Dallas,51087,Henrico,VA,Richmond,64,2784000,43500.0,73,2840000,38904.109589041094,-9,-56000
2018,county,48085,Collin,51087,Henrico,VA,Richmond,86,3301000,38383.72093023256,49,2057000,41979.5918367347,37,1244000
2018,county,48439,Tarrant,48215,Hidalgo,TX,Rural Texas,282,5025000,17819.14893617021,219,3907000,17840.182648401827,63,1118000
2018,county,48113,Dallas,48215,Hidalgo,TX,Rural Texas,391,8255000,21112.531969309464,331,6011000,18160.12084592145,60,2244000
2018,county,48121,Denton,48215,Hidalgo,TX,Rural Texas,87,2145000,24655.172413793105,63,1383000,21952.380952380954,24,762000
2018,county,48085,Collin,48215,Hidalgo,TX,Rural Texas,97,3400000,35051.54639175258,51,1108000,21725.49019607843,46,2292000
2018,county,48439,Tarrant,48217,Hill,TX,Rural Texas,166,3546000,21361.44578313253,287,7225000,25174.216027874565,-121,-3679000
2018,county,48113,Dallas,48217,Hill,TX,Rural Texas,71,1763000,24830.985915492958,173,3034000,17537.57225433526,-102,-1271000
2018,county,48439,Tarrant,12057,Hillsborough,FL,Tampa,199,6096000,30633.165829145728,256,8214000,32085.9375,-57,-2118000
2018,county,48439,Tarrant,33011,Hillsborough,NH,Rural New Hampshire,60,1733000,28883.333333333332,46,1852000,40260.86956521739,14,-119000
2018,county,48113,Dallas,12057,Hillsborough,FL,Tampa,271,13176000,48619.926199261994,276,10314000,37369.565217391304,-5,2862000
2018,county,48113,Dallas,33011,Hillsborough,NH,Rural New Hampshire,38,2338000,61526.31578947369,33,1694000,51333.333333333336,5,644000
2018,county,48121,Denton,12057,Hillsborough,FL,Tampa,123,4205000,34186.9918699187,111,3642000,32810.81081081081,12,563000
2018,county,48085,Collin,12057,Hillsborough,FL,Tampa,183,7846000,42874.31693989071,134,5489000,40962.68656716418,49,2357000
2018,county,48439,Tarrant,28049,Hinds,MS,Jackson,261,3836000,14697.318007662836,74,925000,12500.0,187,2911000
2018,county,48113,Dallas,28049,Hinds,MS,Jackson,233,3495000,15000.0,81,1543000,19049.382716049382,152,1952000
2018,county,48439,Tarrant,15003,Honolulu,HI,Rural Hawaii,244,5955000,24405.737704918032,168,5196000,30928.571428571428,76,759000
2018,county,48113,Dallas,15003,Honolulu,HI,Rural Hawaii,164,10578000,64500.0,134,4658000,34761.19402985075,30,5920000
2018,county,48121,Denton,15003,Honolulu,HI,Rural Hawaii,92,2501000,27184.782608695652,47,2180000,46382.97872340425,45,321000
2018,county,48085,Collin,15003,Honolulu,HI,Rural Hawaii,113,3359000,29725.66371681416,73,2652000,36328.767123287675,40,707000
2018,county,48439,Tarrant,48221,Hood,TX,Rural Texas,699,23613000,33781.11587982833,1304,44036000,33769.93865030675,-605,-20423000
2018,county,48113,Dallas,48221,Hood,TX,Rural Texas,87,3268000,37563.2183908046,221,10907000,49352.94117647059,-134,-7639000
2018,county,48121,Denton,48221,Hood,TX,Rural Texas,74,2294000,31000.0,181,9171000,50668.50828729282,-107,-6877000
2018,county,48439,Tarrant,48223,Hopkins,TX,Rural Texas,49,1241000,25326.530612244896,67,2272000,33910.44776119403,-18,-1031000
2018,county,48113,Dallas,48223,Hopkins,TX,Rural Texas,93,1856000,19956.989247311827,182,5144000,28263.736263736264,-89,-3288000
2018,county,48085,Collin,48223,Hopkins,TX,Rural Texas,60,2026000,33766.666666666664,93,3624000,38967.74193548387,-33,-1598000
2018,county,48439,Tarrant,48227,Howard,TX,Rural Texas,64,1213000,18953.125,54,1132000,20962.962962962964,10,81000
2018,county,48113,Dallas,24027,Howard,MD,Baltimore,56,4321000,77160.71428571429,44,1647000,37431.818181818184,12,2674000
2018,county,48085,Collin,24027,Howard,MD,Baltimore,53,2665000,50283.018867924526,44,2721000,61840.90909090909,9,-56000
2018,county,48439,Tarrant,34017,Hudson,NJ,New York,80,1709000,21362.5,46,1987000,43195.65217391304,34,-278000
2018,county,48113,Dallas,34017,Hudson,NJ,New York,223,12500000,56053.81165919283,129,7181000,55666.666666666664,94,5319000
2018,county,48085,Collin,34017,Hudson,NJ,New York,188,8214000,43691.48936170213,53,2292000,43245.28301886792,135,5922000
2018,county,48439,Tarrant,48231,Hunt,TX,Dallas-Fort Worth,176,3937000,22369.31818181818,306,6724000,21973.856209150326,-130,-2787000
2018,county,48113,Dallas,48231,Hunt,TX,Dallas-Fort Worth,791,15911000,20115.04424778761,1642,34887000,21246.650426309378,-851,-18976000
2018,county,48121,Denton,48231,Hunt,TX,Dallas-Fort Worth,129,2917000,22612.403100775195,201,5841000,29059.701492537315,-72,-2924000
2018,county,48085,Collin,48231,Hunt,TX,Dallas-Fort Worth,623,14592000,23422.15088282504,1051,26621000,25329.21027592769,-428,-12029000
2018,county,48439,Tarrant,48237,Jack,TX,Rural Texas,45,1288000,28622.222222222223,52,2144000,41230.769230769234,-7,-856000
2018,county,48439,Tarrant,29095,Jackson,MO,Kansas City,185,5423000,29313.513513513513,140,2668000,19057.14285714286,45,2755000
2018,county,48113,Dallas,29095,Jackson,MO,Kansas City,232,8178000,35250.0,170,4030000,23705.882352941175,62,4148000
2018,county,48121,Denton,29095,Jackson,MO,Kansas City,87,3644000,41885.057471264365,67,1843000,27507.462686567163,20,1801000
2018,county,48085,Collin,29095,Jackson,MO,Kansas City,133,3235000,24323.30827067669,54,1820000,33703.7037037037,79,1415000
2018,county,48439,Tarrant,48245,Jefferson,TX,Rural Texas,244,5209000,21348.360655737706,71,1592000,22422.535211267605,173,3617000
2018,county,48439,Tarrant,21111,Jefferson,KY,Louisville,75,1898000,25306.666666666668,90,2377000,26411.11111111111,-15,-479000
2018,county,48439,Tarrant,08059,Jefferson,CO,Denver,82,2769000,33768.29268292683,127,5128000,40377.95275590551,-45,-2359000
2018,county,48439,Tarrant,01073,Jefferson,AL,Birmingham,89,2243000,25202.247191011236,59,1818000,30813.5593220339,30,425000
2018,county,48113,Dallas,48245,Jefferson,TX,Rural Texas,221,3623000,16393.66515837104,114,1714000,15035.087719298246,107,1909000
2018,county,48113,Dallas,01073,Jefferson,AL,Birmingham,155,7288000,47019.354838709674,117,5596000,47829.05982905983,38,1692000
2018,county,48113,Dallas,21111,Jefferson,KY,Louisville,115,4943000,42982.608695652176,105,3101000,29533.333333333332,10,1842000
2018,county,48113,Dallas,08059,Jefferson,CO,Denver,73,4180000,57260.27397260274,134,9169000,68425.37313432836,-61,-4989000
2018,county,48121,Denton,08059,Jefferson,CO,Denver,50,2909000,58180.0,88,2852000,32409.090909090908,-38,57000
2018,county,48121,Denton,21111,Jefferson,KY,Louisville,49,3123000,63734.69387755102,50,2266000,45320.0,-1,857000
2018,county,48085,Collin,08059,Jefferson,CO,Denver,66,2684000,40666.666666666664,111,4482000,40378.37837837838,-45,-1798000
2018,county,48085,Collin,21111,Jefferson,KY,Louisville,64,4553000,71140.625,46,2940000,63913.04347826087,18,1613000
2018,county,48439,Tarrant,22051,Jefferson Parish,LA,New Orleans,111,2403000,21648.64864864865,43,1094000,25441.86046511628,68,1309000
2018,county,48113,Dallas,22051,Jefferson Parish,LA,New Orleans,206,3819000,18538.834951456312,147,2400000,16326.530612244898,59,1419000
2018,county,48121,Denton,22051,Jefferson Parish,LA,New Orleans,98,2844000,29020.408163265307,35,1251000,35742.857142857145,63,1593000
2018,county,48085,Collin,22051,Jefferson Parish,LA,New Orleans,70,1683000,24042.85714285714,72,2632000,36555.555555555555,-2,-949000
2018,county,48439,Tarrant,48251,Johnson,TX,Dallas-Fort Worth,4048,101562000,25089.426877470356,7166,177118000,24716.4387384873,-3118,-75556000
2018,county,48439,Tarrant,20091,Johnson,KS,Kansas City,186,8885000,47768.81720430108,150,5632000,37546.666666666664,36,3253000
2018,county,48113,Dallas,48251,Johnson,TX,Dallas-Fort Worth,421,10450000,24821.85273159145,926,23155000,25005.399568034558,-505,-12705000
2018,county,48113,Dallas,20091,Johnson,KS,Kansas City,188,28155000,149760.63829787233,181,9322000,51502.76243093923,7,18833000
2018,county,48121,Denton,48251,Johnson,TX,Dallas-Fort Worth,226,7269000,32163.716814159292,202,6319000,31282.178217821784,24,950000
2018,county,48121,Denton,20091,Johnson,KS,Kansas City,104,6197000,59586.53846153846,98,4178000,42632.65306122449,6,2019000
2018,county,48085,Collin,20091,Johnson,KS,Kansas City,219,8159000,37255.707762557075,125,4760000,38080.0,94,3399000
2018,county,48085,Collin,48251,Johnson,TX,Dallas-Fort Worth,109,2965000,27201.83486238532,115,3667000,31886.956521739132,-6,-702000
2018,county,48113,Dallas,17089,Kane,IL,Chicago,70,2750000,39285.71428571428,38,1085000,28552.63157894737,32,1665000
2018,county,48439,Tarrant,48257,Kaufman,TX,Dallas-Fort Worth,362,8596000,23745.85635359116,551,14971000,27170.59891107078,-189,-6375000
2018,county,48113,Dallas,48257,Kaufman,TX,Dallas-Fort Worth,2479,53918000,21749.899152884227,7353,163943000,22296.069631442948,-4874,-110025000
2018,county,48121,Denton,48257,Kaufman,TX,Dallas-Fort Worth,200,5989000,29945.0,454,14002000,30841.409691629957,-254,-8013000
2018,county,48085,Collin,48257,Kaufman,TX,Dallas-Fort Worth,453,12725000,28090.507726269316,698,21057000,30167.621776504297,-245,-8332000
2018,county,48113,Dallas,48259,Kendall,TX,Rural Texas,31,1123000,36225.8064516129,66,3888000,58909.09090909091,-35,-2765000
2018,county,48439,Tarrant,26081,Kent,MI,Rural Michigan,62,1424000,22967.74193548387,60,1917000,31950.0,2,-493000
2018,county,48113,Dallas,26081,Kent,MI,Rural Michigan,72,1963000,27263.88888888889,61,1512000,24786.885245901638,11,451000
2018,county,48439,Tarrant,06029,Kern,CA,Rural California,152,5441000,35796.05263157895,85,1443000,16976.470588235294,67,3998000
2018,county,48113,Dallas,48265,Kerr,TX,Rural Texas,32,1798000,56187.5,38,1732000,45578.94736842105,-6,66000
2018,county,48439,Tarrant,53033,King,WA,Seattle,358,16040000,44804.469273743016,350,20954000,59868.57142857143,8,-4914000
2018,county,48113,Dallas,53033,King,WA,Seattle,491,34791000,70857.43380855398,654,44949000,68729.35779816513,-163,-10158000
2018,county,48121,Denton,53033,King,WA,Seattle,288,13603000,47232.63888888889,235,15230000,64808.51063829787,53,-1627000
2018,county,48085,Collin,53033,King,WA,Seattle,340,21821000,64179.41176470588,591,38137000,64529.610829103214,-251,-16316000
2018,county,48439,Tarrant,36047,Kings,NY,New York,153,3963000,25901.960784313724,74,1965000,26554.054054054053,79,1998000
2018,county,48113,Dallas,36047,Kings,NY,New York,258,11469000,44453.48837209302,190,10133000,53331.57894736842,68,1336000
2018,county,48121,Denton,36047,Kings,NY,New York,68,1799000,26455.882352941175,46,1863000,40500.0,22,-64000
2018,county,48085,Collin,36047,Kings,NY,New York,132,3932000,29787.878787878788,69,1972000,28579.710144927536,63,1960000
2018,county,48439,Tarrant,47093,Knox,TN,Knoxville,72,2259000,31375.0,52,2445000,47019.230769230766,20,-186000
2018,county,48113,Dallas,47093,Knox,TN,Knoxville,57,2435000,42719.29824561404,45,1590000,35333.333333333336,12,845000
2018,county,48439,Tarrant,22055,Lafayette Parish,LA,Rural Louisiana,80,2586000,32325.0,82,2110000,25731.70731707317,-2,476000
2018,county,48113,Dallas,22055,Lafayette Parish,LA,Rural Louisiana,133,3027000,22759.398496240603,86,3556000,41348.83720930233,47,-529000
2018,county,48439,Tarrant,17097,Lake,IL,Chicago,112,7458000,66589.28571428571,66,2233000,33833.333333333336,46,5225000
2018,county,48113,Dallas,17097,Lake,IL,Chicago,133,5618000,42240.6015037594,87,3218000,36988.50574712644,46,2400000
2018,county,48085,Collin,17097,Lake,IL,Chicago,139,6276000,45151.07913669065,48,1196000,24916.666666666668,91,5080000
2018,county,48439,Tarrant,48277,Lamar,TX,Rural Texas,74,1513000,20445.945945945947,92,1927000,20945.652173913044,-18,-414000
2018,county,48113,Dallas,48277,Lamar,TX,Rural Texas,146,2025000,13869.86301369863,124,2349000,18943.548387096773,22,-324000
2018,county,48121,Denton,48277,Lamar,TX,Rural Texas,50,1055000,21100.0,68,1954000,28735.29411764706,-18,-899000
2018,county,48085,Collin,48277,Lamar,TX,Rural Texas,50,1550000,31000.0,64,2293000,35828.125,-14,-743000
2018,county,48439,Tarrant,31109,Lancaster,NE,Rural Nebraska,49,1227000,25040.816326530614,46,935000,20326.08695652174,3,292000
2018,county,48439,Tarrant,08069,Larimer,CO,Rural Colorado,56,2115000,37767.857142857145,138,5027000,36427.536231884056,-82,-2912000
2018,county,48113,Dallas,08069,Larimer,CO,Rural Colorado,59,2178000,36915.254237288136,61,2928000,48000.0,-2,-750000
2018,county,48121,Denton,08069,Larimer,CO,Rural Colorado,53,2308000,43547.16981132075,53,2575000,48584.90566037736,0,-267000
2018,county,48085,Collin,08069,Larimer,CO,Rural Colorado,53,1830000,34528.301886792455,52,2630000,50576.92307692308,1,-800000
2018,county,48439,Tarrant,12071,Lee,FL,S.W. Florida,89,2446000,27483.14606741573,85,3996000,47011.76470588235,4,-1550000
2018,county,48113,Dallas,12071,Lee,FL,S.W. Florida,101,5980000,59207.92079207921,87,5134000,59011.49425287356,14,846000
2018,county,48121,Denton,12071,Lee,FL,S.W. Florida,79,2808000,35544.303797468354,41,2576000,62829.26829268293,38,232000
2018,county,48085,Collin,12071,Lee,FL,S.W. Florida,39,1615000,41410.256410256414,62,3112000,50193.54838709677,-23,-1497000
2018,county,48113,Dallas,48293,Limestone,TX,Rural Texas,35,613000,17514.285714285714,38,775000,20394.736842105263,-3,-162000
2018,county,48439,Tarrant,06037,Los Angeles,CA,Los Angeles,1366,48601000,35579.06295754026,732,26237000,35842.89617486339,634,22364000
2018,county,48113,Dallas,06037,Los Angeles,CA,Los Angeles,1552,85617000,55165.592783505155,1218,60337000,49537.76683087028,334,25280000
2018,county,48121,Denton,06037,Los Angeles,CA,Los Angeles,901,51436000,57087.680355160934,336,11780000,35059.52380952381,565,39656000
2018,county,48085,Collin,06037,Los Angeles,CA,Los Angeles,2018,114665000,56821.1100099108,481,27918000,58041.58004158004,1537,86747000
2018,county,48439,Tarrant,51107,Loudoun,VA,Rural Virginia,74,3733000,50445.94594594595,80,2568000,32100.0,-6,1165000
2018,county,48113,Dallas,51107,Loudoun,VA,Rural Virginia,68,3332000,49000.0,68,2460000,36176.470588235294,0,872000
2018,county,48121,Denton,51107,Loudoun,VA,Rural Virginia,54,3050000,56481.48148148148,59,2841000,48152.542372881355,-5,209000
2018,county,48085,Collin,51107,Loudoun,VA,Rural Virginia,135,5312000,39348.148148148146,75,5514000,73520.0,60,-202000
2018,county,48439,Tarrant,48303,Lubbock,TX,Rural Texas,601,15393000,25612.312811980035,406,11496000,28315.27093596059,195,3897000
2018,county,48113,Dallas,48303,Lubbock,TX,Rural Texas,500,14696000,29392.0,365,9700000,26575.342465753423,135,4996000
2018,county,48121,Denton,48303,Lubbock,TX,Rural Texas,262,8894000,33946.564885496184,156,3600000,23076.923076923078,106,5294000
2018,county,48085,Collin,48303,Lubbock,TX,Rural Texas,294,9658000,32850.34013605442,171,5200000,30409.356725146197,123,4458000
2018,county,48439,Tarrant,26099,Macomb,MI,Rural Michigan,71,1341000,18887.323943661973,61,2770000,45409.83606557377,10,-1429000
2018,county,48113,Dallas,26099,Macomb,MI,Rural Michigan,52,2815000,54134.61538461538,33,899000,27242.424242424244,19,1916000
2018,county,48439,Tarrant,01089,Madison,AL,Huntsville,66,2135000,32348.484848484848,74,2665000,36013.51351351351,-8,-530000
2018,county,48113,Dallas,01089,Madison,AL,Huntsville,47,1750000,37234.04255319149,67,2761000,41208.9552238806,-20,-1011000
2018,county,48439,Tarrant,12081,Manatee,FL,Rural Florida,32,1281000,40031.25,54,2286000,42333.333333333336,-22,-1005000
2018,county,48113,Dallas,12081,Manatee,FL,Rural Florida,34,839000,24676.470588235294,46,1705000,37065.217391304344,-12,-866000
2018,county,48085,Collin,12081,Manatee,FL,Rural Florida,51,4488000,88000.0,75,4779000,63720.0,-24,-291000
2018,county,48439,Tarrant,04013,Maricopa,AZ,Phoenix,832,29980000,36033.653846153844,746,28540000,38257.37265415549,86,1440000
2018,county,48113,Dallas,04013,Maricopa,AZ,Phoenix,830,49945000,60174.698795180724,850,67601000,79530.58823529411,-20,-17656000
2018,county,48121,Denton,04013,Maricopa,AZ,Phoenix,484,20241000,41820.2479338843,439,20728000,47216.400911161734,45,-487000
2018,county,48085,Collin,04013,Maricopa,AZ,Phoenix,738,28407000,38491.86991869919,531,24130000,45442.56120527307,207,4277000
2018,county,48439,Tarrant,18097,Marion,IN,Indianapolis,140,3020000,21571.428571428572,93,1614000,17354.83870967742,47,1406000
2018,county,48113,Dallas,18097,Marion,IN,Indianapolis,175,6143000,35102.857142857145,148,4340000,29324.324324324323,27,1803000
2018,county,48121,Denton,18097,Marion,IN,Indianapolis,47,1683000,35808.51063829787,79,2251000,28493.67088607595,-32,-568000
2018,county,48085,Collin,18097,Marion,IN,Indianapolis,76,2790000,36710.52631578947,38,1867000,49131.57894736842,38,923000
2018,county,48085,Collin,17113,McLean,IL,Rural Illinois,323,15184000,47009.2879256966,52,2558000,49192.307692307695,271,12626000
2018,county,48439,Tarrant,48309,McLennan,TX,Rural Texas,488,12647000,25915.983606557376,499,13078000,26208.416833667336,-11,-431000
2018,county,48113,Dallas,48309,McLennan,TX,Rural Texas,507,13132000,25901.38067061144,442,11227000,25400.452488687784,65,1905000
2018,county,48121,Denton,48309,McLennan,TX,Rural Texas,152,4059000,26703.947368421053,149,4916000,32993.288590604025,3,-857000
2018,county,48085,Collin,48309,McLennan,TX,Rural Texas,169,5060000,29940.828402366864,127,5412000,42614.17322834646,42,-352000
2018,county,48439,Tarrant,37119,Mecklenburg,NC,Charlotte,144,5335000,37048.61111111111,159,7063000,44421.38364779874,-15,-1728000
2018,county,48113,Dallas,37119,Mecklenburg,NC,Charlotte,372,19415000,52190.86021505376,302,34993000,115870.86092715232,70,-15578000
2018,county,48121,Denton,37119,Mecklenburg,NC,Charlotte,105,3913000,37266.666666666664,72,3459000,48041.666666666664,33,454000
2018,county,48085,Collin,37119,Mecklenburg,NC,Charlotte,188,8714000,46351.063829787236,197,8946000,45411.16751269036,-9,-232000
2018,county,48439,Tarrant,12086,Miami-Dade,FL,Miami,350,9833000,28094.285714285714,138,5670000,41086.95652173913,212,4163000
2018,county,48113,Dallas,12086,Miami-Dade,FL,Miami,479,19851000,41442.58872651357,321,11994000,37364.48598130841,158,7857000
2018,county,48121,Denton,12086,Miami-Dade,FL,Miami,154,4975000,32305.194805194806,83,4378000,52746.98795180723,71,597000
2018,county,48085,Collin,12086,Miami-Dade,FL,Miami,203,7847000,38655.1724137931,116,5453000,47008.620689655174,87,2394000
2018,county,48439,Tarrant,25017,Middlesex,MA,Boston,96,3805000,39635.416666666664,81,3934000,48567.9012345679,15,-129000
2018,county,48439,Tarrant,34023,Middlesex,NJ,New York,92,2853000,31010.869565217392,46,2412000,52434.782608695656,46,441000
2018,county,48113,Dallas,25017,Middlesex,MA,Boston,186,12751000,68553.76344086022,171,9715000,56812.865497076025,15,3036000
2018,county,48113,Dallas,34023,Middlesex,NJ,New York,250,9509000,38036.0,125,5171000,41368.0,125,4338000
2018,county,48121,Denton,25017,Middlesex,MA,Boston,66,3209000,48621.21212121212,40,2313000,57825.0,26,896000
2018,county,48085,Collin,34023,Middlesex,NJ,New York,373,13428000,36000.0,85,3458000,40682.35294117647,288,9970000
2018,county,48085,Collin,25017,Middlesex,MA,Boston,198,10011000,50560.606060606064,72,3929000,54569.444444444445,126,6082000
2018,county,48439,Tarrant,48329,Midland,TX,Rural Texas,445,19814000,44525.84269662921,370,13038000,35237.83783783784,75,6776000
2018,county,48113,Dallas,48329,Midland,TX,Rural Texas,252,13123000,52075.39682539683,272,9508000,34955.882352941175,-20,3615000
2018,county,48121,Denton,48329,Midland,TX,Rural Texas,211,12073000,57218.00947867298,134,4916000,36686.567164179105,77,7157000
2018,county,48085,Collin,48329,Midland,TX,Rural Texas,144,9015000,62604.166666666664,109,4745000,43532.11009174312,35,4270000
2018,county,48439,Tarrant,55079,Milwaukee,WI,Milwaukee,224,4217000,18825.89285714286,113,2230000,19734.513274336285,111,1987000
2018,county,48113,Dallas,55079,Milwaukee,WI,Milwaukee,294,6582000,22387.755102040817,105,2535000,24142.85714285714,189,4047000
2018,county,48085,Collin,55079,Milwaukee,WI,Milwaukee,91,2431000,26714.285714285714,55,1017000,18490.909090909092,36,1414000
2018,county,48439,Tarrant,01097,Mobile,AL,Mobile,89,1357000,15247.191011235955,41,1142000,27853.658536585364,48,215000
2018,county,48113,Dallas,01097,Mobile,AL,Mobile,59,1951000,33067.79661016949,42,1130000,26904.761904761905,17,821000
2018,county,48113,Dallas,36055,Monroe,NY,Rochester,49,2705000,55204.08163265306,55,3521000,64018.181818181816,-6,-816000
2018,county,48439,Tarrant,48337,Montague,TX,Rural Texas,98,1861000,18989.79591836735,164,4177000,25469.51219512195,-66,-2316000
2018,county,48121,Denton,48337,Montague,TX,Rural Texas,88,1346000,15295.454545454546,176,6991000,39721.59090909091,-88,-5645000
2018,county,48439,Tarrant,48339,Montgomery,TX,Houston,400,18464000,46160.0,974,63845000,65549.28131416837,-574,-45381000
2018,county,48439,Tarrant,24031,Montgomery,MD,D.C.,133,9147000,68774.43609022556,94,3479000,37010.63829787234,39,5668000
2018,county,48439,Tarrant,47125,Montgomery,TN,Rural Tennessee,74,1584000,21405.405405405407,71,1186000,16704.225352112677,3,398000
2018,county,48439,Tarrant,39113,Montgomery,OH,Rural Ohio,49,1060000,21632.65306122449,68,1378000,20264.70588235294,-19,-318000
2018,county,48113,Dallas,48339,Montgomery,TX,Houston,334,16421000,49164.67065868263,465,28601000,61507.52688172043,-131,-12180000
2018,county,48113,Dallas,24031,Montgomery,MD,D.C.,151,7773000,51476.82119205298,162,11587000,71524.69135802469,-11,-3814000
2018,county,48113,Dallas,42091,Montgomery,PA,Philadelphia,77,5963000,77441.55844155845,94,7087000,75393.6170212766,-17,-1124000
2018,county,48113,Dallas,39113,Montgomery,OH,Rural Ohio,49,1362000,27795.918367346938,43,1435000,33372.09302325582,6,-73000
2018,county,48113,Dallas,47125,Montgomery,TN,Rural Tennessee,38,642000,16894.736842105263,56,949000,16946.428571428572,-18,-307000
2018,county,48121,Denton,48339,Montgomery,TX,Houston,211,7213000,34184.83412322275,296,14187000,47929.05405405405,-85,-6974000
2018,county,48121,Denton,24031,Montgomery,MD,D.C.,53,2522000,47584.90566037736,52,1887000,36288.46153846154,1,635000
2018,county,48085,Collin,48339,Montgomery,TX,Houston,193,11191000,57984.455958549224,241,14657000,60817.427385892115,-48,-3466000
2018,county,48085,Collin,24031,Montgomery,MD,D.C.,112,5457000,48723.21428571428,63,2338000,37111.11111111111,49,3119000
2018,county,48439,Tarrant,41051,Multnomah,OR,Portland,73,2372000,32493.15068493151,94,3405000,36223.40425531915,-21,-1033000
2018,county,48113,Dallas,41051,Multnomah,OR,Portland,101,3112000,30811.881188118812,129,6208000,48124.03100775194,-28,-3096000
2018,county,48085,Collin,41051,Multnomah,OR,Portland,35,1329000,37971.42857142857,31,1169000,37709.67741935484,4,160000
2018,county,48439,Tarrant,48347,Nacogdoches,TX,Rural Texas,78,1654000,21205.128205128207,69,1219000,17666.666666666668,9,435000
2018,county,48113,Dallas,48347,Nacogdoches,TX,Rural Texas,111,1744000,15711.711711711712,88,1481000,16829.545454545456,23,263000
2018,county,48113,Dallas,36059,Nassau,NY,New York,95,3001000,31589.473684210527,51,2437000,47784.313725490196,44,564000
2018,county,48439,Tarrant,48349,Navarro,TX,Rural Texas,121,3285000,27148.760330578512,177,5718000,32305.084745762713,-56,-2433000
2018,county,48113,Dallas,48349,Navarro,TX,Rural Texas,311,6015000,19340.836012861735,614,12219000,19900.651465798044,-303,-6204000
2018,county,48121,Denton,48349,Navarro,TX,Rural Texas,35,1055000,30142.85714285714,47,1409000,29978.72340425532,-12,-354000
2018,county,48085,Collin,48349,Navarro,TX,Rural Texas,49,1852000,37795.91836734694,47,2174000,46255.31914893617,2,-322000
2018,county,48113,Dallas,10003,New Castle,DE,Rural Delaware,89,3431000,38550.56179775281,76,2707000,35618.42105263158,13,724000
2018,county,48085,Collin,10003,New Castle,DE,Rural Delaware,40,2016000,50400.0,39,1306000,33487.179487179485,1,710000
2018,county,48439,Tarrant,09009,New Haven,CT,New Haven,60,2340000,39000.0,50,2189000,43780.0,10,151000
2018,county,48113,Dallas,09009,New Haven,CT,New Haven,56,2407000,42982.142857142855,48,2175000,45312.5,8,232000
2018,county,48439,Tarrant,36061,New York,NY,New York,99,9070000,91616.16161616161,100,7226000,72260.0,-1,1844000
2018,county,48113,Dallas,36061,New York,NY,New York,462,94013000,203491.341991342,459,40365000,87941.17647058824,3,53648000
2018,county,48121,Denton,36061,New York,NY,New York,68,4845000,71250.0,62,6517000,105112.90322580645,6,-1672000
2018,county,48085,Collin,36061,New York,NY,New York,108,11469000,106194.44444444444,99,9382000,94767.67676767676,9,2087000
2018,county,48113,Dallas,25021,Norfolk,MA,Boston,106,7407000,69877.35849056604,63,2693000,42746.031746031746,43,4714000
2018,county,48439,Tarrant,51710,Norfolk city,VA,Hampton Roads,59,1053000,17847.457627118645,52,1523000,29288.46153846154,7,-470000
2018,county,48113,Dallas,51710,Norfolk city,VA,Hampton Roads,88,2030000,23068.18181818182,43,977000,22720.93023255814,45,1053000
2018,county,48439,Tarrant,48355,Nueces,TX,Rural Texas,207,7676000,37082.12560386473,185,5668000,30637.837837837837,22,2008000
2018,county,48113,Dallas,48355,Nueces,TX,Rural Texas,193,5714000,29606.21761658031,177,5871000,33169.49152542373,16,-157000
2018,county,48121,Denton,48355,Nueces,TX,Rural Texas,129,4388000,34015.50387596899,95,2849000,29989.473684210527,34,1539000
2018,county,48085,Collin,48355,Nueces,TX,Rural Texas,107,3426000,32018.69158878505,66,1727000,26166.666666666668,41,1699000
2018,county,48439,Tarrant,26125,Oakland,MI,Detroit,163,5497000,33723.926380368095,141,4390000,31134.751773049644,22,1107000
2018,county,48113,Dallas,26125,Oakland,MI,Detroit,150,6685000,44566.666666666664,157,8443000,53777.07006369427,-7,-1758000
2018,county,48121,Denton,26125,Oakland,MI,Detroit,101,4426000,43821.78217821782,84,2451000,29178.571428571428,17,1975000
2018,county,48085,Collin,26125,Oakland,MI,Detroit,253,10291000,40675.88932806324,116,4031000,34750.0,137,6260000
2018,county,48439,Tarrant,12091,Okaloosa,FL,FL Panhandle,110,3635000,33045.454545454544,66,2072000,31393.939393939392,44,1563000
2018,county,48439,Tarrant,40109,Oklahoma,OK,Oklahoma City,532,23407000,43998.12030075188,471,14214000,30178.343949044585,61,9193000
2018,county,48113,Dallas,40109,Oklahoma,OK,Oklahoma City,612,26391000,43122.549019607846,533,22470000,42157.59849906191,79,3921000
2018,county,48121,Denton,40109,Oklahoma,OK,Oklahoma City,298,11674000,39174.4966442953,193,8079000,41860.103626943004,105,3595000
2018,county,48085,Collin,40109,Oklahoma,OK,Oklahoma City,371,13406000,36134.770889487874,222,10160000,45765.76576576577,149,3246000
2018,county,48439,Tarrant,37133,Onslow,NC,Rural North Carolina,113,2094000,18530.973451327434,47,701000,14914.893617021276,66,1393000
2018,county,48439,Tarrant,06059,Orange,CA,Los Angeles,643,30076000,46774.49455676517,297,15319000,51579.12457912458,346,14757000
2018,county,48439,Tarrant,12095,Orange,FL,Orlando,265,8789000,33166.03773584906,252,12353000,49019.84126984127,13,-3564000
2018,county,48113,Dallas,06059,Orange,CA,Los Angeles,670,45054000,67244.77611940299,369,22243000,60279.13279132792,301,22811000
2018,county,48113,Dallas,12095,Orange,FL,Orlando,275,10581000,38476.36363636364,287,10071000,35090.59233449477,-12,510000
2018,county,48121,Denton,06059,Orange,CA,Los Angeles,494,34477000,69791.4979757085,186,10555000,56747.31182795699,308,23922000
2018,county,48121,Denton,12095,Orange,FL,Orlando,132,5083000,38507.57575757576,106,3699000,34896.22641509434,26,1384000
2018,county,48085,Collin,06059,Orange,CA,Los Angeles,988,48729000,49320.85020242915,278,14125000,50809.352517985615,710,34604000
2018,county,48085,Collin,12095,Orange,FL,Orlando,212,9027000,42580.188679245286,150,6141000,40940.0,62,2886000
2018,county,48439,Tarrant,22071,Orleans Parish,LA,New Orleans,149,5031000,33765.10067114094,84,3202000,38119.04761904762,65,1829000
2018,county,48113,Dallas,22071,Orleans Parish,LA,New Orleans,219,6033000,27547.945205479453,199,8670000,43567.8391959799,20,-2637000
2018,county,48085,Collin,22071,Orleans Parish,LA,New Orleans,89,1534000,17235.955056179777,39,698000,17897.4358974359,50,836000
2018,county,48439,Tarrant,12097,Osceola,FL,Orlando,50,889000,17780.0,64,1791000,27984.375,-14,-902000
2018,county,48113,Dallas,12097,Osceola,FL,Orlando,56,1106000,19750.0,45,1423000,31622.222222222223,11,-317000
2018,county,48439,Tarrant,22073,Ouachita Parish,LA,Rural Louisiana,255,3141000,12317.64705882353,97,1450000,14948.453608247422,158,1691000
2018,county,48113,Dallas,22073,Ouachita Parish,LA,Rural Louisiana,286,4524000,15818.181818181818,138,1790000,12971.014492753624,148,2734000
2018,county,48439,Tarrant,12099,Palm Beach,FL,Miami,152,5263000,34625.0,142,6314000,44464.788732394365,10,-1051000
2018,county,48113,Dallas,12099,Palm Beach,FL,Miami,215,9575000,44534.88372093023,236,13427000,56894.06779661017,-21,-3852000
2018,county,48121,Denton,12099,Palm Beach,FL,Miami,119,3629000,30495.798319327732,93,6867000,73838.70967741935,26,-3238000
2018,county,48085,Collin,12099,Palm Beach,FL,Miami,130,4220000,32461.53846153846,139,7130000,51294.96402877698,-9,-2910000
2018,county,48439,Tarrant,48363,Palo Pinto,TX,Rural Texas,185,5138000,27772.972972972973,298,7348000,24657.71812080537,-113,-2210000
2018,county,48121,Denton,48363,Palo Pinto,TX,Rural Texas,41,1607000,39195.12195121951,48,2451000,51062.5,-7,-844000
2018,county,48439,Tarrant,48367,Parker,TX,Dallas-Fort Worth,2934,154250000,52573.27880027267,5836,222275000,38086.8745716244,-2902,-68025000
2018,county,48113,Dallas,48367,Parker,TX,Dallas-Fort Worth,179,4506000,25173.1843575419,359,18143000,50537.60445682451,-180,-13637000
2018,county,48121,Denton,48367,Parker,TX,Dallas-Fort Worth,188,7836000,41680.85106382979,385,13582000,35277.92207792208,-197,-5746000
2018,county,48085,Collin,48367,Parker,TX,Dallas-Fort Worth,114,4136000,36280.70175438596,158,5829000,36892.40506329114,-44,-1693000
2018,county,48439,Tarrant,12101,Pasco,FL,Tampa,64,2221000,34703.125,75,1697000,22626.666666666668,-11,524000
2018,county,48113,Dallas,12101,Pasco,FL,Tampa,37,975000,26351.35135135135,50,2138000,42760.0,-13,-1163000
2018,county,48439,Tarrant,42101,Philadelphia,PA,Philadelphia,77,1664000,21610.38961038961,54,2334000,43222.22222222222,23,-670000
2018,county,48113,Dallas,42101,Philadelphia,PA,Philadelphia,146,6416000,43945.20547945205,104,6584000,63307.692307692305,42,-168000
2018,county,48121,Denton,42101,Philadelphia,PA,Philadelphia,44,1725000,39204.545454545456,27,1056000,39111.11111111111,17,669000
2018,county,48085,Collin,42101,Philadelphia,PA,Philadelphia,64,1917000,29953.125,45,1945000,43222.22222222222,19,-28000
2018,county,48439,Tarrant,53053,Pierce,WA,Seattle,226,5368000,23752.21238938053,136,4445000,32683.823529411766,90,923000
2018,county,48113,Dallas,53053,Pierce,WA,Seattle,147,3711000,25244.897959183672,86,3137000,36476.74418604651,61,574000
2018,county,48121,Denton,53053,Pierce,WA,Seattle,86,2361000,27453.488372093023,50,1410000,28200.0,36,951000
2018,county,48085,Collin,53053,Pierce,WA,Seattle,84,3696000,44000.0,75,2262000,30160.0,9,1434000
2018,county,48439,Tarrant,04019,Pima,AZ,Tucson,252,11258000,44674.60317460317,147,5081000,34564.62585034013,105,6177000
2018,county,48113,Dallas,04019,Pima,AZ,Tucson,151,7954000,52675.496688741725,151,6219000,41185.43046357616,0,1735000
2018,county,48121,Denton,04019,Pima,AZ,Tucson,124,3818000,30790.322580645163,57,2594000,45508.771929824565,67,1224000
2018,county,48085,Collin,04019,Pima,AZ,Tucson,148,6377000,43087.83783783784,95,3650000,38421.05263157895,53,2727000
2018,county,48439,Tarrant,04021,Pinal,AZ,Phoenix,75,2233000,29773.333333333332,49,1922000,39224.489795918365,26,311000
2018,county,48439,Tarrant,12103,Pinellas,FL,Tampa,81,2542000,31382.716049382718,106,4300000,40566.03773584906,-25,-1758000
2018,county,48113,Dallas,12103,Pinellas,FL,Tampa,135,5706000,42266.666666666664,154,8911000,57863.63636363636,-19,-3205000
2018,county,48121,Denton,12103,Pinellas,FL,Tampa,65,3075000,47307.692307692305,92,4111000,44684.782608695656,-27,-1036000
2018,county,48085,Collin,12103,Pinellas,FL,Tampa,75,4724000,62986.666666666664,88,8547000,97125.0,-13,-3823000
2018,county,48439,Tarrant,12105,Polk,FL,Orlando,113,2844000,25168.141592920354,75,2005000,26733.333333333332,38,839000
2018,county,48439,Tarrant,19153,Polk,IA,Rural Iowa,42,664000,15809.52380952381,46,1481000,32195.652173913044,-4,-817000
2018,county,48439,Tarrant,48373,Polk,TX,Rural Texas,37,1259000,34027.02702702703,102,4914000,48176.470588235294,-65,-3655000
2018,county,48113,Dallas,19153,Polk,IA,Rural Iowa,79,4015000,50822.784810126584,63,2080000,33015.87301587302,16,1935000
2018,county,48113,Dallas,12105,Polk,FL,Orlando,65,1677000,25800.0,50,1139000,22780.0,15,538000
2018,county,48085,Collin,19153,Polk,IA,Rural Iowa,66,1745000,26439.39393939394,49,1231000,25122.448979591838,17,514000
2018,county,48439,Tarrant,48375,Potter,TX,Rural Texas,172,4024000,23395.3488372093,141,2459000,17439.71631205674,31,1565000
2018,county,48113,Dallas,48375,Potter,TX,Rural Texas,145,3397000,23427.58620689655,113,1829000,16185.840707964602,32,1568000
2018,county,48439,Tarrant,24033,Prince George,MD,Rural Maryland,129,3327000,25790.697674418603,74,2015000,27229.72972972973,55,1312000
2018,county,48113,Dallas,24033,Prince George,MD,Rural Maryland,134,3443000,25694.02985074627,90,2185000,24277.777777777777,44,1258000
2018,county,48439,Tarrant,51153,Prince William,VA,Rural Virginia,105,2907000,27685.714285714286,53,1771000,33415.09433962264,52,1136000
2018,county,48113,Dallas,51153,Prince William,VA,Rural Virginia,74,2234000,30189.18918918919,45,769000,17088.88888888889,29,1465000
2018,county,48085,Collin,51153,Prince William,VA,Rural Virginia,66,2398000,36333.333333333336,70,1498000,21400.0,-4,900000
2018,county,48113,Dallas,44007,Providence,RI,Providence,77,2410000,31298.7012987013,45,1802000,40044.444444444445,32,608000
2018,county,48439,Tarrant,05119,Pulaski,AR,Little Rock,259,5355000,20675.675675675677,209,3949000,18894.736842105263,50,1406000
2018,county,48113,Dallas,05119,Pulaski,AR,Little Rock,378,12299000,32537.037037037036,289,8377000,28986.159169550174,89,3922000
2018,county,48121,Denton,05119,Pulaski,AR,Little Rock,134,4020000,30000.0,90,3922000,43577.77777777778,44,98000
2018,county,48085,Collin,05119,Pulaski,AR,Little Rock,186,4551000,24467.74193548387,105,3501000,33342.857142857145,81,1050000
2018,county,48439,Tarrant,36081,Queens,NY,New York,170,5785000,34029.41176470588,85,1764000,20752.941176470587,85,4021000
2018,county,48113,Dallas,36081,Queens,NY,New York,299,11265000,37675.58528428094,158,4694000,29708.86075949367,141,6571000
2018,county,48085,Collin,36081,Queens,NY,New York,217,5210000,24009.21658986175,63,2070000,32857.142857142855,154,3140000
2018,county,48113,Dallas,48379,Rains,TX,Rural Texas,40,955000,23875.0,134,4209000,31410.44776119403,-94,-3254000
2018,county,48439,Tarrant,27123,Ramsey,MN,Minneapolis,58,1432000,24689.655172413793,49,1690000,34489.795918367345,9,-258000
2018,county,48113,Dallas,27123,Ramsey,MN,Minneapolis,64,1688000,26375.0,68,1721000,25308.823529411766,-4,-33000
2018,county,48439,Tarrant,48381,Randall,TX,Rural Texas,243,7833000,32234.567901234568,171,5050000,29532.16374269006,72,2783000
2018,county,48113,Dallas,48381,Randall,TX,Rural Texas,119,3855000,32394.95798319328,113,3034000,26849.557522123894,6,821000
2018,county,48121,Denton,48381,Randall,TX,Rural Texas,88,3746000,42568.181818181816,83,2602000,31349.397590361445,5,1144000
2018,county,48085,Collin,48381,Randall,TX,Rural Texas,125,5159000,41272.0,79,2585000,32721.518987341773,46,2574000
2018,county,48113,Dallas,22079,Rapides Parish,LA,Rural Louisiana,83,1310000,15783.132530120482,35,473000,13514.285714285714,48,837000
2018,county,48113,Dallas,45079,Richland,SC,Columbia,37,1807000,48837.83783783784,43,1470000,34186.04651162791,-6,337000
2018,county,48439,Tarrant,06065,Riverside,CA,San Bernardino-Riverside,436,14944000,34275.22935779816,239,6110000,25564.853556485356,197,8834000
2018,county,48113,Dallas,06065,Riverside,CA,San Bernardino-Riverside,248,7851000,31657.25806451613,249,5733000,23024.09638554217,-1,2118000
2018,county,48121,Denton,06065,Riverside,CA,San Bernardino-Riverside,247,8290000,33562.75303643725,92,1864000,20260.869565217392,155,6426000
2018,county,48085,Collin,06065,Riverside,CA,San Bernardino-Riverside,250,9041000,36164.0,121,3763000,31099.173553719007,129,5278000
2018,county,48439,Tarrant,48397,Rockwall,TX,Dallas-Fort Worth,177,6843000,38661.016949152545,302,10233000,33884.105960264904,-125,-3390000
2018,county,48113,Dallas,48397,Rockwall,TX,Dallas-Fort Worth,1950,68198000,34973.333333333336,3766,125946000,33442.9102496017,-1816,-57748000
2018,county,48121,Denton,48397,Rockwall,TX,Dallas-Fort Worth,219,6085000,27785.388127853883,320,11968000,37400.0,-101,-5883000
2018,county,48085,Collin,48397,Rockwall,TX,Dallas-Fort Worth,955,33705000,35293.193717277485,1153,41117000,35660.88464874241,-198,-7412000
2018,county,48439,Tarrant,48401,Rusk,TX,Rural Texas,37,667000,18027.027027027027,65,978000,15046.153846153846,-28,-311000
2018,county,48113,Dallas,48401,Rusk,TX,Rural Texas,74,1522000,20567.567567567567,52,883000,16980.76923076923,22,639000
2018,county,48439,Tarrant,47149,Rutherford,TN,Nashville,60,1316000,21933.333333333332,55,1294000,23527.272727272728,5,22000
2018,county,48113,Dallas,47149,Rutherford,TN,Nashville,39,725000,18589.74358974359,41,1262000,30780.48780487805,-2,-537000
2018,county,48439,Tarrant,06067,Sacramento,CA,Sacramento,240,9377000,39070.833333333336,150,3674000,24493.333333333332,90,5703000
2018,county,48113,Dallas,06067,Sacramento,CA,Sacramento,158,5339000,33791.13924050633,153,6886000,45006.535947712415,5,-1547000
2018,county,48121,Denton,06067,Sacramento,CA,Sacramento,84,3891000,46321.42857142857,37,1583000,42783.78378378379,47,2308000
2018,county,48085,Collin,06067,Sacramento,CA,Sacramento,125,8463000,67704.0,64,2307000,36046.875,61,6156000
2018,county,48439,Tarrant,05125,Saline,AR,Little Rock,48,1330000,27708.333333333332,44,1499000,34068.181818181816,4,-169000
2018,county,48113,Dallas,05125,Saline,AR,Little Rock,40,847000,21175.0,59,1764000,29898.305084745763,-19,-917000
2018,county,48439,Tarrant,49035,Salt Lake,UT,Salt Lake,173,4119000,23809.248554913294,142,6414000,45169.01408450704,31,-2295000
2018,county,48113,Dallas,49035,Salt Lake,UT,Salt Lake,214,8226000,38439.2523364486,205,6797000,33156.09756097561,9,1429000
2018,county,48121,Denton,49035,Salt Lake,UT,Salt Lake,109,4643000,42596.33027522936,96,3233000,33677.083333333336,13,1410000
2018,county,48085,Collin,49035,Salt Lake,UT,Salt Lake,136,3790000,27867.647058823528,126,4862000,38587.30158730159,10,-1072000
2018,county,48439,Tarrant,06071,San Bernardino,CA,San Bernardino-Riverside,498,11340000,22771.0843373494,305,4929000,16160.655737704918,193,6411000
2018,county,48113,Dallas,06071,San Bernardino,CA,San Bernardino-Riverside,304,7360000,24210.526315789473,197,4926000,25005.07614213198,107,2434000
2018,county,48121,Denton,06071,San Bernardino,CA,San Bernardino-Riverside,153,5220000,34117.64705882353,37,775000,20945.945945945947,116,4445000
2018,county,48085,Collin,06071,San Bernardino,CA,San Bernardino-Riverside,228,7865000,34495.61403508772,71,2362000,33267.605633802814,157,5503000
2018,county,48439,Tarrant,06073,San Diego,CA,San Diego,819,31633000,38623.931623931625,513,15418000,30054.58089668616,306,16215000
2018,county,48113,Dallas,06073,San Diego,CA,San Diego,751,42279000,56296.93741677763,530,21100000,39811.32075471698,221,21179000
2018,county,48121,Denton,06073,San Diego,CA,San Diego,266,10287000,38672.93233082707,223,9512000,42654.708520179374,43,775000
2018,county,48085,Collin,06073,San Diego,CA,San Diego,548,19862000,36244.52554744526,270,14627000,54174.07407407407,278,5235000
2018,county,48439,Tarrant,06075,San Francisco,CA,Bay Area,62,3939000,63532.25806451613,50,2159000,43180.0,12,1780000
2018,county,48113,Dallas,06075,San Francisco,CA,Bay Area,219,23223000,106041.09589041096,159,14032000,88251.57232704402,60,9191000
2018,county,48085,Collin,06075,San Francisco,CA,Bay Area,82,6767000,82524.39024390244,60,4488000,74800.0,22,2279000
2018,county,48439,Tarrant,06077,San Joaquin,CA,Bay Area,64,2099000,32796.875,57,836000,14666.666666666666,7,1263000
2018,county,48439,Tarrant,06081,San Mateo,CA,Bay Area,62,5684000,91677.41935483871,65,3994000,61446.153846153844,-3,1690000
2018,county,48113,Dallas,06081,San Mateo,CA,Bay Area,124,14018000,113048.3870967742,145,16512000,113875.86206896552,-21,-2494000
2018,county,48085,Collin,06081,San Mateo,CA,Bay Area,67,6277000,93686.5671641791,47,2615000,55638.29787234042,20,3662000
2018,county,48439,Tarrant,35043,Sandoval,NM,Albuquerque,75,1694000,22586.666666666668,51,2430000,47647.05882352941,24,-736000
2018,county,48113,Dallas,06083,Santa Barbara,CA,Rural California,62,3867000,62370.967741935485,36,1739000,48305.555555555555,26,2128000
2018,county,48439,Tarrant,06085,Santa Clara,CA,Bay Area,212,14244000,67188.67924528301,162,7281000,44944.444444444445,50,6963000
2018,county,48113,Dallas,06085,Santa Clara,CA,Bay Area,376,21371000,56837.765957446805,343,24003000,69979.59183673469,33,-2632000
2018,county,48121,Denton,06085,Santa Clara,CA,Bay Area,183,12038000,65781.42076502732,110,6149000,55900.0,73,5889000
2018,county,48085,Collin,06085,Santa Clara,CA,Bay Area,529,30401000,57468.809073724005,342,23509000,68739.76608187135,187,6892000
2018,county,48439,Tarrant,35049,Santa Fe,NM,Rural New Mexico,50,578000,11560.0,49,2152000,43918.36734693877,1,-1574000
2018,county,48113,Dallas,35049,Santa Fe,NM,Rural New Mexico,36,16366000,454611.1111111111,83,4056000,48867.469879518074,-47,12310000
2018,county,48113,Dallas,12115,Sarasota,FL,S.W. Florida,45,1594000,35422.22222222222,68,2868000,42176.470588235294,-23,-1274000
2018,county,48439,Tarrant,05131,Sebastian,AR,Rural Arkansas,63,2318000,36793.65079365079,64,1424000,22250.0,-1,894000
2018,county,48439,Tarrant,20173,Sedgwick,KS,Rural Kansas,263,6943000,26399.239543726235,172,4632000,26930.232558139534,91,2311000
2018,county,48113,Dallas,20173,Sedgwick,KS,Rural Kansas,208,6747000,32437.5,137,3625000,26459.85401459854,71,3122000
2018,county,48121,Denton,20173,Sedgwick,KS,Rural Kansas,58,2363000,40741.379310344826,75,1640000,21866.666666666668,-17,723000
2018,county,48085,Collin,20173,Sedgwick,KS,Rural Kansas,97,2895000,29845.360824742267,66,1748000,26484.848484848484,31,1147000
2018,county,48439,Tarrant,12117,Seminole,FL,Orlando,80,2505000,31312.5,62,2272000,36645.16129032258,18,233000
2018,county,48113,Dallas,12117,Seminole,FL,Orlando,79,2928000,37063.29113924051,85,3479000,40929.41176470588,-6,-551000
2018,county,48121,Denton,12117,Seminole,FL,Orlando,66,2213000,33530.30303030303,52,2393000,46019.230769230766,14,-180000
2018,county,48085,Collin,12117,Seminole,FL,Orlando,89,3116000,35011.23595505618,50,1948000,38960.0,39,1168000
2018,county,48439,Tarrant,20177,Shawnee,KS,Rural Kansas,49,1175000,23979.591836734693,39,1038000,26615.384615384617,10,137000
2018,county,48439,Tarrant,47157,Shelby,TN,Memphis,335,8575000,25597.014925373136,222,5282000,23792.792792792792,113,3293000
2018,county,48113,Dallas,47157,Shelby,TN,Memphis,434,13774000,31737.327188940093,277,8481000,30617.328519855597,157,5293000
2018,county,48121,Denton,47157,Shelby,TN,Memphis,166,4017000,24198.795180722893,86,2676000,31116.279069767443,80,1341000
2018,county,48085,Collin,47157,Shelby,TN,Memphis,199,7014000,35246.23115577889,137,5658000,41299.2700729927,62,1356000
2018,county,48439,Tarrant,48423,Smith,TX,Rural Texas,492,13239000,26908.536585365855,426,11937000,28021.12676056338,66,1302000
2018,county,48113,Dallas,48423,Smith,TX,Rural Texas,690,19640000,28463.768115942028,708,21571000,30467.514124293786,-18,-1931000
2018,county,48121,Denton,48423,Smith,TX,Rural Texas,251,6468000,25768.924302788844,206,6592000,32000.0,45,-124000
2018,county,48085,Collin,48423,Smith,TX,Rural Texas,361,10120000,28033.240997229917,246,8003000,32532.52032520325,115,2117000
2018,county,48439,Tarrant,53061,Snohomish,WA,Seattle,126,3814000,30269.84126984127,152,4645000,30559.21052631579,-26,-831000
2018,county,48113,Dallas,53061,Snohomish,WA,Seattle,94,3762000,40021.27659574468,121,5248000,43371.90082644628,-27,-1486000
2018,county,48121,Denton,53061,Snohomish,WA,Seattle,73,3813000,52232.87671232877,85,2469000,29047.058823529413,-12,1344000
2018,county,48085,Collin,53061,Snohomish,WA,Seattle,151,5166000,34211.920529801326,91,2555000,28076.923076923078,60,2611000
2018,county,48439,Tarrant,06095,Solano,CA,Bay Area,73,2035000,27876.712328767124,43,929000,21604.6511627907,30,1106000
2018,county,48113,Dallas,34035,Somerset,NJ,New York,58,4562000,78655.1724137931,42,2238000,53285.71428571428,16,2324000
2018,county,48439,Tarrant,48425,Somervell,TX,Rural Texas,52,1097000,21096.153846153848,127,4655000,36653.54330708661,-75,-3558000
2018,county,48439,Tarrant,53063,Spokane,WA,Spokane,68,1235000,18161.764705882353,40,2040000,51000.0,28,-805000
2018,county,48439,Tarrant,29183,St. Charles,MO,St. Louis,86,3820000,44418.604651162794,66,2851000,43196.969696969696,20,969000
2018,county,48113,Dallas,29183,St. Charles,MO,St. Louis,80,4114000,51425.0,58,2425000,41810.34482758621,22,1689000
2018,county,48439,Tarrant,29189,St. Louis,MO,St. Louis,269,16237000,60360.59479553904,115,8105000,70478.26086956522,154,8132000
2018,county,48113,Dallas,29189,St. Louis,MO,St. Louis,355,11609000,32701.408450704224,195,8631000,44261.53846153846,160,2978000
2018,county,48121,Denton,29189,St. Louis,MO,St. Louis,116,4175000,35991.379310344826,79,3564000,45113.92405063291,37,611000
2018,county,48085,Collin,29189,St. Louis,MO,St. Louis,277,15893000,57375.45126353791,101,3686000,36495.0495049505,176,12207000
2018,county,48113,Dallas,29510,St. Louis city,MO,Rural Missouri,141,6070000,43049.645390070924,86,4038000,46953.48837209302,55,2032000
2018,county,48439,Tarrant,22103,St. Tammany Parish,LA,New Orleans,46,1774000,38565.217391304344,51,2286000,44823.529411764706,-5,-512000
2018,county,48113,Dallas,22103,St. Tammany Parish,LA,New Orleans,47,2380000,50638.29787234042,56,2390000,42678.57142857143,-9,-10000
2018,county,48439,Tarrant,36103,Suffolk,NY,New York,96,2703000,28156.25,35,1139000,32542.85714285714,61,1564000
2018,county,48439,Tarrant,25025,Suffolk,MA,Boston,74,2099000,28364.864864864863,42,1544000,36761.90476190476,32,555000
2018,county,48113,Dallas,25025,Suffolk,MA,Boston,136,9585000,70477.94117647059,128,7875000,61523.4375,8,1710000
2018,county,48113,Dallas,36103,Suffolk,NY,New York,119,4192000,35226.89075630252,57,1829000,32087.719298245614,62,2363000
2018,county,48113,Dallas,39153,Summit,OH,Rural Ohio,40,1762000,44050.0,43,969000,22534.883720930233,-3,793000
2018,county,48113,Dallas,48439,Tarrant,TX,Dallas-Fort Worth,19943,554900000,27824.29925287068,24884,684877000,27522.78572576756,-4941,-129977000
2018,county,48121,Denton,48439,Tarrant,TX,Dallas-Fort Worth,9238,392039000,42437.648841740636,7614,286288000,37600.21013921723,1624,105751000
2018,county,48085,Collin,48439,Tarrant,TX,Dallas-Fort Worth,3377,119014000,35242.52294936334,2560,94294000,36833.59375,817,24720000
2018,county,48439,Tarrant,48441,Taylor,TX,Rural Texas,410,9443000,23031.70731707317,341,7827000,22953.07917888563,69,1616000
2018,county,48113,Dallas,48441,Taylor,TX,Rural Texas,268,6107000,22787.31343283582,197,5147000,26126.903553299493,71,960000
2018,county,48121,Denton,48441,Taylor,TX,Rural Texas,110,2997000,27245.454545454544,99,2427000,24515.151515151516,11,570000
2018,county,48085,Collin,48441,Taylor,TX,Rural Texas,93,2899000,31172.043010752688,76,2182000,28710.526315789473,17,717000
2018,county,48439,Tarrant,53067,Thurston,WA,Rural Washington,60,1201000,20016.666666666668,41,1412000,34439.0243902439,19,-211000
2018,county,48113,Dallas,48449,Titus,TX,Rural Texas,91,1817000,19967.032967032967,86,1326000,15418.60465116279,5,491000
2018,county,48439,Tarrant,48451,Tom Green,TX,Rural Texas,176,4958000,28170.454545454544,124,2855000,23024.1935483871,52,2103000
2018,county,48113,Dallas,48451,Tom Green,TX,Rural Texas,138,3765000,27282.608695652172,105,2421000,23057.14285714286,33,1344000
2018,county,48121,Denton,48451,Tom Green,TX,Rural Texas,72,1854000,25750.0,57,1587000,27842.105263157893,15,267000
2018,county,48439,Tarrant,48453,Travis,TX,Austin,1020,37171000,36442.1568627451,1168,47406000,40587.32876712329,-148,-10235000
2018,county,48113,Dallas,48453,Travis,TX,Austin,1826,93801000,51369.66046002191,2049,124475000,60749.14592484139,-223,-30674000
2018,county,48121,Denton,48453,Travis,TX,Austin,647,22724000,35122.10200927357,643,22343000,34748.05598755832,4,381000
2018,county,48085,Collin,48453,Travis,TX,Austin,727,34993000,48133.425034387896,841,42541000,50583.82877526754,-114,-7548000
2018,county,48439,Tarrant,40143,Tulsa,OK,Tulsa,425,15036000,35378.82352941176,341,10810000,31700.879765395894,84,4226000
2018,county,48113,Dallas,40143,Tulsa,OK,Tulsa,424,15819000,37308.96226415094,364,14667000,40293.956043956045,60,1152000
2018,county,48121,Denton,40143,Tulsa,OK,Tulsa,166,5096000,30698.795180722893,184,6113000,33222.82608695652,-18,-1017000
2018,county,48085,Collin,40143,Tulsa,OK,Tulsa,235,8572000,36476.59574468085,187,6970000,37272.72727272727,48,1602000
2018,county,48439,Tarrant,48459,Upshur,TX,Rural Texas,33,787000,23848.484848484848,64,1026000,16031.25,-31,-239000
2018,county,48113,Dallas,48459,Upshur,TX,Rural Texas,44,1075000,24431.81818181818,74,2615000,35337.83783783784,-30,-1540000
2018,county,48439,Tarrant,49049,Utah,UT,Rural Utah,131,2537000,19366.41221374046,94,2721000,28946.808510638297,37,-184000
2018,county,48113,Dallas,49049,Utah,UT,Rural Utah,118,2634000,22322.033898305086,73,3140000,43013.69863013698,45,-506000
2018,county,48121,Denton,49049,Utah,UT,Rural Utah,128,3334000,26046.875,76,1984000,26105.263157894737,52,1350000
2018,county,48085,Collin,49049,Utah,UT,Rural Utah,100,2410000,24100.0,122,3899000,31959.016393442624,-22,-1489000
2018,county,48439,Tarrant,48465,Val Verde,TX,Rural Texas,47,583000,12404.255319148937,63,1222000,19396.825396825396,-16,-639000
2018,county,48439,Tarrant,48467,Van Zandt,TX,Rural Texas,98,2459000,25091.836734693876,165,4540000,27515.151515151516,-67,-2081000
2018,county,48113,Dallas,48467,Van Zandt,TX,Rural Texas,276,7746000,28065.217391304348,573,15021000,26214.659685863873,-297,-7275000
2018,county,48121,Denton,48467,Van Zandt,TX,Rural Texas,43,1069000,24860.46511627907,92,3207000,34858.69565217391,-49,-2138000
2018,county,48085,Collin,48467,Van Zandt,TX,Rural Texas,60,1925000,32083.333333333332,91,2516000,27648.351648351647,-31,-591000
2018,county,48439,Tarrant,06111,Ventura,CA,Los Angeles,168,3903000,23232.14285714286,93,2116000,22752.68817204301,75,1787000
2018,county,48113,Dallas,06111,Ventura,CA,Los Angeles,144,5988000,41583.333333333336,41,1058000,25804.878048780487,103,4930000
2018,county,48085,Collin,06111,Ventura,CA,Los Angeles,164,8522000,51963.41463414634,56,2275000,40625.0,108,6247000
2018,county,48439,Tarrant,51810,Virginia Beach city,VA,Hampton Roads,119,2721000,22865.546218487394,109,2497000,22908.256880733945,10,224000
2018,county,48113,Dallas,51810,Virginia Beach city,VA,Hampton Roads,93,3790000,40752.68817204301,70,1728000,24685.714285714286,23,2062000
2018,county,48085,Collin,51810,Virginia Beach city,VA,Hampton Roads,61,2109000,34573.770491803276,54,1702000,31518.51851851852,7,407000
2018,county,48439,Tarrant,12127,Volusia,FL,Atlantic Coast,37,754000,20378.37837837838,50,1868000,37360.0,-13,-1114000
2018,county,48113,Dallas,12127,Volusia,FL,Atlantic Coast,47,1088000,23148.936170212764,54,1523000,28203.703703703704,-7,-435000
2018,county,48439,Tarrant,37183,Wake,NC,Raleigh,90,2814000,31266.666666666668,110,4284000,38945.454545454544,-20,-1470000
2018,county,48113,Dallas,37183,Wake,NC,Raleigh,182,9867000,54214.28571428572,180,12095000,67194.44444444444,2,-2228000
2018,county,48121,Denton,37183,Wake,NC,Raleigh,81,3078000,38000.0,108,5038000,46648.148148148146,-27,-1960000
2018,county,48085,Collin,37183,Wake,NC,Raleigh,217,9088000,41880.18433179724,128,7967000,62242.1875,89,1121000
2018,county,48439,Tarrant,48471,Walker,TX,Rural Texas,51,1138000,22313.725490196077,46,973000,21152.17391304348,5,165000
2018,county,48113,Dallas,48471,Walker,TX,Rural Texas,74,1390000,18783.783783783783,66,2060000,31212.121212121212,8,-670000
2018,county,48439,Tarrant,05143,Washington,AR,Rural Arkansas,49,1447000,29530.61224489796,95,2966000,31221.052631578947,-46,-1519000
2018,county,48439,Tarrant,41067,Washington,OR,Portland,58,2428000,41862.06896551724,71,2408000,33915.49295774648,-13,20000
2018,county,48113,Dallas,05143,Washington,AR,Rural Arkansas,110,3184000,28945.454545454544,133,4713000,35436.09022556391,-23,-1529000
2018,county,48113,Dallas,41067,Washington,OR,Portland,104,4695000,45144.230769230766,118,4917000,41669.49152542373,-14,-222000
2018,county,48113,Dallas,28151,Washington,MS,Rural Mississippi,76,712000,9368.421052631578,60,429000,7150.0,16,283000
2018,county,48121,Denton,05143,Washington,AR,Rural Arkansas,56,1569000,28017.85714285714,43,1628000,37860.46511627907,13,-59000
2018,county,48085,Collin,41067,Washington,OR,Portland,105,4549000,43323.80952380953,86,4265000,49593.023255813954,19,284000
2018,county,48085,Collin,05143,Washington,AR,Rural Arkansas,56,2560000,45714.28571428572,70,2085000,29785.714285714286,-14,475000
2018,county,48439,Tarrant,32031,Washoe,NV,Rural Nevada,69,2460000,35652.17391304348,51,1253000,24568.62745098039,18,1207000
2018,county,48113,Dallas,32031,Washoe,NV,Rural Nevada,45,2506000,55688.88888888889,64,2183000,34109.375,-19,323000
2018,county,48439,Tarrant,26161,Washtenaw,MI,Rural Michigan,49,1200000,24489.79591836735,38,1989000,52342.10526315789,11,-789000
2018,county,48113,Dallas,26161,Washtenaw,MI,Rural Michigan,56,3628000,64785.71428571428,54,3206000,59370.37037037037,2,422000
2018,county,48085,Collin,26161,Washtenaw,MI,Rural Michigan,67,4081000,60910.44776119403,48,2904000,60500.0,19,1177000
2018,county,48439,Tarrant,26163,Wayne,MI,Detroit,165,4043000,24503.030303030304,139,2501000,17992.805755395682,26,1542000
2018,county,48113,Dallas,26163,Wayne,MI,Detroit,180,4956000,27533.333333333332,122,4076000,33409.83606557377,58,880000
2018,county,48121,Denton,26163,Wayne,MI,Detroit,86,3182000,37000.0,41,1193000,29097.560975609755,45,1989000
2018,county,48085,Collin,26163,Wayne,MI,Detroit,124,5597000,45137.096774193546,71,2778000,39126.76056338028,53,2819000
2018,county,48439,Tarrant,48479,Webb,TX,Rural Texas,118,2014000,17067.79661016949,66,1434000,21727.272727272728,52,580000
2018,county,48113,Dallas,48479,Webb,TX,Rural Texas,252,3111000,12345.238095238095,183,1952000,10666.666666666666,69,1159000
2018,county,48113,Dallas,08123,Weld,CO,Rural Colorado,48,992000,20666.666666666668,52,1946000,37423.07692307692,-4,-954000
2018,county,48113,Dallas,36119,Westchester,NY,New York,96,6033000,62843.75,37,1809000,48891.89189189189,59,4224000
2018,county,48439,Tarrant,48485,Wichita,TX,Rural Texas,381,11336000,29753.280839895015,351,7477000,21301.994301994302,30,3859000
2018,county,48113,Dallas,48485,Wichita,TX,Rural Texas,230,6635000,28847.82608695652,219,5147000,23502.28310502283,11,1488000
2018,county,48121,Denton,48485,Wichita,TX,Rural Texas,202,5082000,25158.41584158416,113,3229000,28575.221238938055,89,1853000
2018,county,48085,Collin,48485,Wichita,TX,Rural Texas,120,3479000,28991.666666666668,90,2660000,29555.555555555555,30,819000
2018,county,48439,Tarrant,17197,Will,IL,Chicago,106,4423000,41726.41509433962,75,2182000,29093.333333333332,31,2241000
2018,county,48113,Dallas,17197,Will,IL,Chicago,104,2638000,25365.384615384617,52,1487000,28596.153846153848,52,1151000
2018,county,48121,Denton,17197,Will,IL,Chicago,75,3151000,42013.333333333336,40,2596000,64900.0,35,555000
2018,county,48439,Tarrant,48491,Williamson,TX,Austin,512,17883000,34927.734375,581,20660000,35559.380378657486,-69,-2777000
2018,county,48113,Dallas,48491,Williamson,TX,Austin,496,18389000,37074.596774193546,609,24017000,39436.7816091954,-113,-5628000
2018,county,48113,Dallas,47187,Williamson,TN,Nashville,67,2427000,36223.880597014926,78,3333000,42730.769230769234,-11,-906000
2018,county,48121,Denton,48491,Williamson,TX,Austin,302,11453000,37923.84105960265,347,14823000,42717.57925072046,-45,-3370000
2018,county,48085,Collin,48491,Williamson,TX,Austin,428,17601000,41123.831775700935,468,22080000,47179.48717948718,-40,-4479000
2018,county,48085,Collin,47187,Williamson,TN,Nashville,83,5382000,64843.3734939759,82,3685000,44939.0243902439,1,1697000
2018,county,48439,Tarrant,48497,Wise,TX,Dallas-Fort Worth,992,26109000,26319.5564516129,2004,61892000,30884.23153692615,-1012,-35783000
2018,county,48113,Dallas,48497,Wise,TX,Dallas-Fort Worth,86,2576000,29953.488372093023,158,5264000,33316.45569620253,-72,-2688000
2018,county,48121,Denton,48497,Wise,TX,Dallas-Fort Worth,435,12964000,29802.298850574713,956,29964000,31343.09623430962,-521,-17000000
2018,county,48085,Collin,48497,Wise,TX,Dallas-Fort Worth,61,3051000,50016.39344262295,57,2274000,39894.73684210526,4,777000
2018,county,48439,Tarrant,48499,Wood,TX,Rural Texas,65,1521000,23400.0,185,5235000,28297.297297297297,-120,-3714000
2018,county,48113,Dallas,48499,Wood,TX,Rural Texas,74,2067000,27932.432432432433,215,8594000,39972.09302325582,-141,-6527000
2018,county,48121,Denton,48499,Wood,TX,Rural Texas,47,1057000,22489.36170212766,81,3349000,41345.67901234568,-34,-2292000
2018,county,48085,Collin,48499,Wood,TX,Rural Texas,61,2855000,46803.27868852459,134,5407000,40350.746268656716,-73,-2552000
2018,county,48439,Tarrant,25027,Worcester,MA,Rural Massachusetts,54,1510000,27962.962962962964,43,1535000,35697.67441860465,11,-25000
2018,county,48439,Tarrant,48503,Young,TX,Rural Texas,48,1741000,36270.833333333336,72,2782000,38638.88888888889,-24,-1041000
2018,total,48439,Tarrant,96000,,,,104512,3295717000,31534.340554194732,102592,3365597000,32805.64761384903,1920,-69880000
2018,total,48113,Dallas,96000,,,,117798,4748091000,40307.05954260683,140929,5026924000,35669.90470378701,-23131,-278833000
2018,total,48121,Denton,96000,,,,69748,2711365000,38873.7311464128,57944,2281370000,39371.979842606655,11804,429995000
2018,total,48085,Collin,96000,,,,82800,3422375000,41333.03140096618,62689,2801762000,44693.040246295204,20111,620613000
2019,county,48439,Tarrant,16001,Ada,ID,Rural Idaho,48,1616000,33666.666666666664,70,1957000,27957.14285714286,-22,-341000
2019,county,48113,Dallas,16001,Ada,ID,Rural Idaho,43,1594000,37069.767441860466,48,3283000,68395.83333333333,-5,-1689000
2019,county,48439,Tarrant,08001,Adams,CO,Denver,133,3655000,27481.203007518798,91,3240000,35604.395604395606,42,415000
2019,county,48113,Dallas,08001,Adams,CO,Denver,63,1946000,30888.88888888889,101,3350000,33168.316831683165,-38,-1404000
2019,county,48121,Denton,08001,Adams,CO,Denver,74,2928000,39567.56756756757,42,1493000,35547.619047619046,32,1435000
2019,county,48085,Collin,08001,Adams,CO,Denver,75,2666000,35546.666666666664,54,2600000,48148.148148148146,21,66000
2019,county,48113,Dallas,12001,Alachua,FL,Rural Florida,55,2590000,47090.90909090909,28,1186000,42357.142857142855,27,1404000
2019,county,48439,Tarrant,06001,Alameda,CA,Bay Area,184,13256000,72043.47826086957,100,4594000,45940.0,84,8662000
2019,county,48113,Dallas,06001,Alameda,CA,Bay Area,381,19269000,50574.8031496063,226,11690000,51725.66371681416,155,7579000
2019,county,48121,Denton,06001,Alameda,CA,Bay Area,162,8735000,53919.753086419754,48,1798000,37458.333333333336,114,6937000
2019,county,48085,Collin,06001,Alameda,CA,Bay Area,359,23530000,65543.17548746518,213,14535000,68239.43661971831,146,8995000
2019,county,48439,Tarrant,51510,Alexandria city,VA,D.C.,49,2822000,57591.836734693876,32,1818000,56812.5,17,1004000
2019,county,48113,Dallas,51510,Alexandria city,VA,D.C.,51,2813000,55156.86274509804,52,2882000,55423.07692307692,-1,-69000
2019,county,48439,Tarrant,42003,Allegheny,PA,Pittsburgh,102,8683000,85127.45098039215,95,3573000,37610.52631578947,7,5110000
2019,county,48113,Dallas,42003,Allegheny,PA,Pittsburgh,183,8035000,43907.10382513661,168,6480000,38571.42857142857,15,1555000
2019,county,48121,Denton,42003,Allegheny,PA,Pittsburgh,68,5971000,87808.82352941176,51,3479000,68215.6862745098,17,2492000
2019,county,48085,Collin,42003,Allegheny,PA,Pittsburgh,101,5120000,50693.069306930694,66,2938000,44515.15151515151,35,2182000
2019,county,48439,Tarrant,18003,Allen,IN,Rural Indiana,52,942000,18115.384615384617,61,1115000,18278.688524590165,-9,-173000
2019,county,48439,Tarrant,02020,Anchorage Borough,AK,Rural Alaska,90,2798000,31088.88888888889,57,1820000,31929.824561403508,33,978000
2019,county,48113,Dallas,02020,Anchorage Borough,AK,Rural Alaska,56,2625000,46875.0,42,1242000,29571.428571428572,14,1383000
2019,county,48439,Tarrant,48001,Anderson,TX,Rural Texas,77,1912000,24831.16883116883,101,2642000,26158.41584158416,-24,-730000
2019,county,48113,Dallas,48001,Anderson,TX,Rural Texas,86,1669000,19406.976744186046,86,1835000,21337.20930232558,0,-166000
2019,county,48121,Denton,48001,Anderson,TX,Rural Texas,51,1082000,21215.686274509804,36,1337000,37138.88888888889,15,-255000
2019,county,48439,Tarrant,48005,Angelina,TX,Rural Texas,56,1838000,32821.42857142857,67,1332000,19880.597014925374,-11,506000
2019,county,48113,Dallas,48005,Angelina,TX,Rural Texas,92,2208000,24000.0,61,1371000,22475.409836065573,31,837000
2019,county,48439,Tarrant,24003,Anne Arundel,MD,Baltimore,62,2195000,35403.22580645161,46,2776000,60347.82608695652,16,-581000
2019,county,48113,Dallas,24003,Anne Arundel,MD,Baltimore,52,3317000,63788.46153846154,43,1934000,44976.74418604651,9,1383000
2019,county,48085,Collin,24003,Anne Arundel,MD,Baltimore,90,2787000,30966.666666666668,46,2116000,46000.0,44,671000
2019,county,48439,Tarrant,08005,Arapahoe,CO,Denver,200,8839000,44195.0,169,5329000,31532.544378698225,31,3510000
2019,county,48113,Dallas,08005,Arapahoe,CO,Denver,184,7336000,39869.565217391304,224,11271000,50316.96428571428,-40,-3935000
2019,county,48121,Denton,08005,Arapahoe,CO,Denver,102,4768000,46745.098039215685,103,3922000,38077.669902912625,-1,846000
2019,county,48085,Collin,08005,Arapahoe,CO,Denver,167,9381000,56173.65269461078,133,4937000,37120.3007518797,34,4444000
2019,county,48439,Tarrant,51013,Arlington,VA,D.C.,46,3987000,86673.91304347826,39,2963000,75974.35897435897,7,1024000
2019,county,48113,Dallas,51013,Arlington,VA,D.C.,97,12912000,133113.40206185568,80,5761000,72012.5,17,7151000
2019,county,48085,Collin,51013,Arlington,VA,D.C.,39,2356000,60410.256410256414,35,1470000,42000.0,4,886000
2019,county,48113,Dallas,24005,Baltimore,MD,Baltimore,78,3269000,41910.256410256414,64,2795000,43671.875,14,474000
2019,county,48113,Dallas,24510,Baltimore city,MD,Baltimore,76,5368000,70631.57894736843,59,3339000,56593.220338983054,17,2029000
2019,county,48439,Tarrant,48021,Bastrop,TX,Austin,47,1397000,29723.40425531915,47,1510000,32127.659574468085,0,-113000
2019,county,48439,Tarrant,45013,Beaufort,SC,Savannah,66,2128000,32242.424242424244,49,2514000,51306.12244897959,17,-386000
2019,county,48439,Tarrant,48027,Bell,TX,Rural Texas,620,12991000,20953.225806451614,468,9556000,20418.803418803418,152,3435000
2019,county,48113,Dallas,48027,Bell,TX,Rural Texas,402,9189000,22858.20895522388,486,8983000,18483.539094650205,-84,206000
2019,county,48121,Denton,48027,Bell,TX,Rural Texas,233,5474000,23493.562231759657,151,3917000,25940.39735099338,82,1557000
2019,county,48085,Collin,48027,Bell,TX,Rural Texas,207,6106000,29497.584541062803,116,3135000,27025.862068965518,91,2971000
2019,county,48439,Tarrant,05007,Benton,AR,Rural Arkansas,86,5042000,58627.90697674418,149,7128000,47838.92617449664,-63,-2086000
2019,county,48113,Dallas,05007,Benton,AR,Rural Arkansas,140,6291000,44935.71428571428,185,8050000,43513.51351351351,-45,-1759000
2019,county,48121,Denton,05007,Benton,AR,Rural Arkansas,134,7176000,53552.23880597015,110,6643000,60390.90909090909,24,533000
2019,county,48085,Collin,05007,Benton,AR,Rural Arkansas,115,7689000,66860.86956521739,167,8192000,49053.89221556886,-52,-503000
2019,county,48113,Dallas,34003,Bergen,NJ,New York,83,6894000,83060.24096385542,64,3707000,57921.875,19,3187000
2019,county,48085,Collin,34003,Bergen,NJ,New York,191,12019000,62926.70157068063,49,3336000,68081.63265306123,142,8683000
2019,county,48439,Tarrant,35001,Bernalillo,NM,Albuquerque,195,5675000,29102.5641025641,142,4828000,34000.0,53,847000
2019,county,48113,Dallas,35001,Bernalillo,NM,Albuquerque,164,5269000,32128.048780487807,139,4622000,33251.79856115108,25,647000
2019,county,48121,Denton,35001,Bernalillo,NM,Albuquerque,95,3747000,39442.10526315789,59,1670000,28305.084745762713,36,2077000
2019,county,48085,Collin,35001,Bernalillo,NM,Albuquerque,107,4792000,44785.04672897196,66,3138000,47545.454545454544,41,1654000
2019,county,48439,Tarrant,48029,Bexar,TX,San Antonio,1251,38286000,30604.31654676259,1098,33982000,30948.998178506376,153,4304000
2019,county,48113,Dallas,48029,Bexar,TX,San Antonio,1400,49762000,35544.28571428572,1237,54550000,44098.62570735651,163,-4788000
2019,county,48121,Denton,48029,Bexar,TX,San Antonio,621,25670000,41336.553945249594,414,14879000,35939.61352657005,207,10791000
2019,county,48085,Collin,48029,Bexar,TX,San Antonio,744,30314000,40744.62365591398,480,19854000,41362.5,264,10460000
2019,county,48439,Tarrant,48035,Bosque,TX,Rural Texas,48,1909000,39770.833333333336,81,2401000,29641.975308641977,-33,-492000
2019,county,48439,Tarrant,22015,Bossier Parish,LA,Rural Louisiana,183,4503000,24606.55737704918,84,1292000,15380.952380952382,99,3211000
2019,county,48113,Dallas,22015,Bossier Parish,LA,Rural Louisiana,184,6260000,34021.739130434784,89,1783000,20033.70786516854,95,4477000
2019,county,48439,Tarrant,08013,Boulder,CO,Denver,54,2030000,37592.59259259259,83,9929000,119626.50602409638,-29,-7899000
2019,county,48113,Dallas,08013,Boulder,CO,Denver,57,2898000,50842.10526315789,78,5066000,64948.717948717946,-21,-2168000
2019,county,48439,Tarrant,48037,Bowie,TX,Rural Texas,111,2423000,21828.828828828828,91,2032000,22329.67032967033,20,391000
2019,county,48113,Dallas,48037,Bowie,TX,Rural Texas,175,3476000,19862.85714285714,193,3594000,18621.76165803109,-18,-118000
2019,county,48121,Denton,48037,Bowie,TX,Rural Texas,74,2220000,30000.0,44,1029000,23386.363636363636,30,1191000
2019,county,48085,Collin,48037,Bowie,TX,Rural Texas,70,1670000,23857.14285714286,72,1859000,25819.444444444445,-2,-189000
2019,county,48439,Tarrant,48039,Brazoria,TX,Houston,122,4436000,36360.65573770492,157,5436000,34624.203821656054,-35,-1000000
2019,county,48113,Dallas,48039,Brazoria,TX,Houston,79,2617000,33126.582278481015,151,4087000,27066.225165562915,-72,-1470000
2019,county,48121,Denton,48039,Brazoria,TX,Houston,73,2647000,36260.27397260274,68,2084000,30647.058823529413,5,563000
2019,county,48085,Collin,48039,Brazoria,TX,Houston,96,3589000,37385.416666666664,78,2842000,36435.89743589744,18,747000
2019,county,48439,Tarrant,48041,Brazos,TX,Rural Texas,329,9447000,28714.285714285714,179,5280000,29497.206703910615,150,4167000
2019,county,48113,Dallas,48041,Brazos,TX,Rural Texas,306,9707000,31722.222222222223,216,7896000,36555.555555555555,90,1811000
2019,county,48121,Denton,48041,Brazos,TX,Rural Texas,130,3735000,28730.76923076923,104,2799000,26913.46153846154,26,936000
2019,county,48085,Collin,48041,Brazos,TX,Rural Texas,162,4219000,26043.20987654321,114,5251000,46061.40350877193,48,-1032000
2019,county,48439,Tarrant,12009,Brevard,FL,Atlantic Coast,56,2345000,41875.0,99,6268000,63313.131313131315,-43,-3923000
2019,county,48113,Dallas,12009,Brevard,FL,Atlantic Coast,72,2209000,30680.555555555555,61,2701000,44278.688524590165,11,-492000
2019,county,48085,Collin,12009,Brevard,FL,Atlantic Coast,55,2039000,37072.72727272727,58,2884000,49724.137931034486,-3,-845000
2019,county,48113,Dallas,36005,Bronx,NY,New York,95,2536000,26694.736842105263,80,1570000,19625.0,15,966000
2019,county,48439,Tarrant,12011,Broward,FL,Miami,228,8676000,38052.63157894737,204,7007000,34348.03921568627,24,1669000
2019,county,48113,Dallas,12011,Broward,FL,Miami,307,19152000,62384.3648208469,332,21288000,64120.48192771084,-25,-2136000
2019,county,48121,Denton,12011,Broward,FL,Miami,176,6375000,36221.59090909091,118,6074000,51474.57627118644,58,301000
2019,county,48085,Collin,12011,Broward,FL,Miami,279,27487000,98519.71326164875,177,12764000,72112.99435028249,102,14723000
2019,county,48439,Tarrant,48049,Brown,TX,Rural Texas,67,1345000,20074.626865671642,49,1115000,22755.102040816328,18,230000
2019,county,48113,Dallas,40013,Bryan,OK,Rural Oklahoma,49,1092000,22285.714285714286,65,1316000,20246.153846153848,-16,-224000
2019,county,48085,Collin,40013,Bryan,OK,Rural Oklahoma,61,1433000,23491.803278688523,93,3464000,37247.31182795699,-32,-2031000
2019,county,48439,Tarrant,34005,Burlington,NJ,Philadelphia,70,2507000,35814.28571428572,48,993000,20687.5,22,1514000
2019,county,48113,Dallas,34005,Burlington,NJ,Philadelphia,57,2562000,44947.36842105263,61,2158000,35377.04918032787,-4,404000
2019,county,48439,Tarrant,48053,Burnet,TX,Rural Texas,37,1165000,31486.486486486487,56,4158000,74250.0,-19,-2993000
2019,county,48439,Tarrant,22017,Caddo Parish,LA,Rural Louisiana,503,10442000,20759.44333996024,169,2995000,17721.89349112426,334,7447000
2019,county,48113,Dallas,22017,Caddo Parish,LA,Rural Louisiana,650,13065000,20100.0,271,3570000,13173.431734317342,379,9495000
2019,county,48121,Denton,22017,Caddo Parish,LA,Rural Louisiana,188,3521000,18728.72340425532,49,1078000,22000.0,139,2443000
2019,county,48085,Collin,22017,Caddo Parish,LA,Rural Louisiana,166,4877000,29379.518072289156,55,965000,17545.454545454544,111,3912000
2019,county,48113,Dallas,22019,Calcasieu Parish,LA,Rural Louisiana,86,1699000,19755.81395348837,65,1039000,15984.615384615385,21,660000
2019,county,48439,Tarrant,48061,Cameron,TX,Rural Texas,167,2854000,17089.82035928144,164,3375000,20579.268292682926,3,-521000
2019,county,48113,Dallas,48061,Cameron,TX,Rural Texas,217,5865000,27027.649769585252,208,4260000,20480.76923076923,9,1605000
2019,county,48121,Denton,48061,Cameron,TX,Rural Texas,68,1700000,25000.0,50,1389000,27780.0,18,311000
2019,county,48085,Collin,48061,Cameron,TX,Rural Texas,36,897000,24916.666666666668,46,1267000,27543.478260869564,-10,-370000
2019,county,48439,Tarrant,40017,Canadian,OK,Oklahoma City,79,2816000,35645.56962025316,87,3395000,39022.988505747126,-8,-579000
2019,county,48113,Dallas,40017,Canadian,OK,Oklahoma City,36,1272000,35333.333333333336,58,1417000,24431.03448275862,-22,-145000
2019,county,48121,Denton,40019,Carter,OK,Rural Oklahoma,35,1174000,33542.857142857145,57,1298000,22771.929824561405,-22,-124000
2019,county,48113,Dallas,45019,Charleston,SC,Charleston,45,2574000,57200.0,48,2350000,48958.333333333336,-3,224000
2019,county,48113,Dallas,13051,Chatham,GA,Savannah,37,1606000,43405.40540540541,43,2473000,57511.62790697674,-6,-867000
2019,county,48439,Tarrant,48073,Cherokee,TX,Rural Texas,50,1320000,26400.0,57,999000,17526.315789473683,-7,321000
2019,county,48113,Dallas,48073,Cherokee,TX,Rural Texas,69,887000,12855.072463768116,34,830000,24411.764705882353,35,57000
2019,county,48439,Tarrant,32003,Clark,NV,Las Vegas,405,16095000,39740.74074074074,400,11832000,29580.0,5,4263000
2019,county,48439,Tarrant,53011,Clark,WA,Portland,77,2324000,30181.81818181818,46,1705000,37065.217391304344,31,619000
2019,county,48113,Dallas,32003,Clark,NV,Las Vegas,502,19147000,38141.434262948205,401,13274000,33102.24438902743,101,5873000
2019,county,48113,Dallas,53011,Clark,WA,Portland,41,2319000,56560.9756097561,49,1525000,31122.448979591838,-8,794000
2019,county,48121,Denton,32003,Clark,NV,Las Vegas,284,13357000,47031.69014084507,168,6077000,36172.619047619046,116,7280000
2019,county,48121,Denton,53011,Clark,WA,Portland,76,2479000,32618.42105263158,43,1412000,32837.20930232558,33,1067000
2019,county,48085,Collin,32003,Clark,NV,Las Vegas,251,10213000,40689.24302788845,205,11323000,55234.14634146341,46,-1110000
2019,county,48113,Dallas,29047,Clay,MO,Kansas City,35,1120000,32000.0,40,900000,22500.0,-5,220000
2019,county,48113,Dallas,13063,Clayton,GA,Atlanta,70,770000,11000.0,78,1135000,14551.28205128205,-8,-365000
2019,county,48439,Tarrant,40027,Cleveland,OK,Oklahoma City,178,6326000,35539.32584269663,171,5389000,31514.619883040934,7,937000
2019,county,48113,Dallas,40027,Cleveland,OK,Oklahoma City,163,6091000,37368.0981595092,123,4006000,32569.10569105691,40,2085000
2019,county,48121,Denton,40027,Cleveland,OK,Oklahoma City,114,3821000,33517.54385964912,90,1503000,16700.0,24,2318000
2019,county,48085,Collin,40027,Cleveland,OK,Oklahoma City,156,6067000,38891.02564102564,80,1818000,22725.0,76,4249000
2019,county,48439,Tarrant,13067,Cobb,GA,Atlanta,143,5562000,38895.104895104894,140,5661000,40435.71428571428,3,-99000
2019,county,48113,Dallas,13067,Cobb,GA,Atlanta,194,11389000,58706.18556701031,202,7007000,34688.11881188119,-8,4382000
2019,county,48121,Denton,13067,Cobb,GA,Atlanta,80,5588000,69850.0,85,4794000,56400.0,-5,794000
2019,county,48085,Collin,13067,Cobb,GA,Atlanta,103,3621000,35155.33980582524,109,5099000,46779.81651376147,-6,-1478000
2019,county,48439,Tarrant,12021,Collier,FL,S.W. Florida,43,1550000,36046.51162790698,70,2864000,40914.28571428572,-27,-1314000
2019,county,48113,Dallas,12021,Collier,FL,S.W. Florida,54,3981000,73722.22222222222,42,4077000,97071.42857142857,12,-96000
2019,county,48439,Tarrant,48085,Collin,TX,Dallas-Fort Worth,2508,105619000,42112.83891547049,3557,124988000,35138.59994377284,-1049,-19369000
2019,county,48113,Dallas,48085,Collin,TX,Dallas-Fort Worth,14890,642812000,43170.71860308932,22942,931959000,40622.39560631157,-8052,-289147000
2019,county,48121,Denton,48085,Collin,TX,Dallas-Fort Worth,17319,839734000,48486.286737109534,11395,484069000,42480.824923211934,5924,355665000
2019,county,48439,Tarrant,48091,Comal,TX,San Antonio,102,6771000,66382.35294117648,128,5147000,40210.9375,-26,1624000
2019,county,48113,Dallas,48091,Comal,TX,San Antonio,95,3450000,36315.78947368421,108,7217000,66824.07407407407,-13,-3767000
2019,county,48121,Denton,48091,Comal,TX,San Antonio,37,2425000,65540.54054054055,106,5173000,48801.88679245283,-69,-2748000
2019,county,48085,Collin,48091,Comal,TX,San Antonio,48,2140000,44583.333333333336,90,4653000,51700.0,-42,-2513000
2019,county,48439,Tarrant,40031,Comanche,OK,Rural Oklahoma,130,2316000,17815.384615384617,105,1808000,17219.04761904762,25,508000
2019,county,48113,Dallas,40031,Comanche,OK,Rural Oklahoma,91,1497000,16450.54945054945,57,830000,14561.40350877193,34,667000
2019,county,48439,Tarrant,06013,Contra Costa,CA,Bay Area,159,8695000,54685.53459119497,66,2610000,39545.454545454544,93,6085000
2019,county,48113,Dallas,06013,Contra Costa,CA,Bay Area,180,12131000,67394.44444444444,135,5999000,44437.03703703704,45,6132000
2019,county,48085,Collin,06013,Contra Costa,CA,Bay Area,157,10563000,67280.25477707006,75,4648000,61973.333333333336,82,5915000
2019,county,48439,Tarrant,17031,Cook,IL,Chicago,736,30764000,41798.913043478264,414,15480000,37391.30434782609,322,15284000
2019,county,48113,Dallas,17031,Cook,IL,Chicago,1203,110333000,91714.87946799668,855,57655000,67432.7485380117,348,52678000
2019,county,48121,Denton,17031,Cook,IL,Chicago,454,18255000,40209.251101321584,164,7222000,44036.58536585366,290,11033000
2019,county,48085,Collin,17031,Cook,IL,Chicago,760,35220000,46342.10526315789,348,13337000,38324.71264367816,412,21883000
2019,county,48439,Tarrant,48097,Cooke,TX,Rural Texas,114,3319000,29114.035087719298,140,7489000,53492.857142857145,-26,-4170000
2019,county,48113,Dallas,48097,Cooke,TX,Rural Texas,84,2941000,35011.90476190476,101,4003000,39633.66336633663,-17,-1062000
2019,county,48121,Denton,48097,Cooke,TX,Rural Texas,530,14067000,26541.509433962263,839,25833000,30790.226460071513,-309,-11766000
2019,county,48085,Collin,48097,Cooke,TX,Rural Texas,70,2581000,36871.42857142857,93,5920000,63655.913978494624,-23,-3339000
2019,county,48439,Tarrant,48099,Coryell,TX,Rural Texas,83,1684000,20289.156626506025,111,1938000,17459.45945945946,-28,-254000
2019,county,48113,Dallas,48099,Coryell,TX,Rural Texas,73,1753000,24013.698630136987,78,1333000,17089.74358974359,-5,420000
2019,county,48439,Tarrant,37051,Cumberland,NC,Rural North Carolina,92,1501000,16315.217391304348,55,825000,15000.0,37,676000
2019,county,48113,Dallas,37051,Cumberland,NC,Rural North Carolina,63,1859000,29507.93650793651,44,699000,15886.363636363636,19,1160000
2019,county,48439,Tarrant,39035,Cuyahoga,OH,Cleveland,107,2613000,24420.560747663552,58,1748000,30137.931034482757,49,865000
2019,county,48113,Dallas,39035,Cuyahoga,OH,Cleveland,142,6451000,45429.57746478873,108,4608000,42666.666666666664,34,1843000
2019,county,48085,Collin,39035,Cuyahoga,OH,Cleveland,105,4159000,39609.52380952381,55,2029000,36890.90909090909,50,2130000
2019,county,48439,Tarrant,27037,Dakota,MN,Minneapolis,53,2686000,50679.24528301887,52,1187000,22826.923076923078,1,1499000
2019,county,48113,Dallas,27037,Dakota,MN,Minneapolis,73,3007000,41191.78082191781,54,1700000,31481.48148148148,19,1307000
2019,county,48439,Tarrant,48113,Dallas,TX,Dallas-Fort Worth,24134,697533000,28902.502693295766,19618,693606000,35355.591803445815,4516,3927000
2019,county,48121,Denton,48113,Dallas,TX,Dallas-Fort Worth,17028,622296000,36545.454545454544,10690,452196000,42300.841908325536,6338,170100000
2019,county,48085,Collin,48113,Dallas,TX,Dallas-Fort Worth,22942,931959000,40622.39560631157,14890,642812000,43170.71860308932,8052,289147000
2019,county,48439,Tarrant,55025,Dane,WI,Madison,74,2367000,31986.486486486487,40,1180000,29500.0,34,1187000
2019,county,48113,Dallas,55025,Dane,WI,Madison,77,3505000,45519.48051948052,34,2066000,60764.705882352944,43,1439000
2019,county,48085,Collin,55025,Dane,WI,Madison,47,1615000,34361.70212765958,41,1888000,46048.78048780488,6,-273000
2019,county,48439,Tarrant,47037,Davidson,TN,Nashville,151,5366000,35536.4238410596,105,4346000,41390.47619047619,46,1020000
2019,county,48113,Dallas,47037,Davidson,TN,Nashville,249,11796000,47373.49397590361,262,17291000,65996.18320610687,-13,-5495000
2019,county,48121,Denton,47037,Davidson,TN,Nashville,91,3993000,43879.12087912088,41,2155000,52560.9756097561,50,1838000
2019,county,48085,Collin,47037,Davidson,TN,Nashville,98,3588000,36612.244897959186,95,4121000,43378.94736842105,3,-533000
2019,county,48439,Tarrant,49011,Davis,UT,Rural Utah,93,3052000,32817.20430107527,72,2347000,32597.222222222223,21,705000
2019,county,48439,Tarrant,13089,DeKalb,GA,Atlanta,79,2612000,33063.29113924051,91,1866000,20505.494505494506,-12,746000
2019,county,48113,Dallas,13089,DeKalb,GA,Atlanta,216,10842000,50194.444444444445,172,9575000,55668.604651162794,44,1267000
2019,county,48085,Collin,13089,DeKalb,GA,Atlanta,96,4656000,48500.0,80,4384000,54800.0,16,272000
2019,county,48439,Tarrant,48121,Denton,TX,Dallas-Fort Worth,7043,394324000,55988.07326423399,10177,405460000,39840.817529723885,-3134,-11136000
2019,county,48113,Dallas,48121,Denton,TX,Dallas-Fort Worth,10690,452196000,42300.841908325536,17028,622296000,36545.454545454544,-6338,-170100000
2019,county,48085,Collin,48121,Denton,TX,Dallas-Fort Worth,11395,484069000,42480.824923211934,17319,839734000,48486.286737109534,-5924,-355665000
2019,county,48439,Tarrant,08031,Denver,CO,Denver,164,7528000,45902.439024390245,198,10776000,54424.242424242424,-34,-3248000
2019,county,48113,Dallas,08031,Denver,CO,Denver,228,14776000,64807.01754385965,472,32274000,68377.1186440678,-244,-17498000
2019,county,48121,Denton,08031,Denver,CO,Denver,73,1887000,25849.31506849315,101,5524000,54693.069306930694,-28,-3637000
2019,county,48085,Collin,08031,Denver,CO,Denver,96,6166000,64229.166666666664,99,4987000,50373.73737373737,-3,1179000
2019,county,48439,Tarrant,11001,District of Columbia,DC,D.C.,55,3983000,72418.18181818182,84,4402000,52404.76190476191,-29,-419000
2019,county,48113,Dallas,11001,District of Columbia,DC,D.C.,188,22710000,120797.87234042553,157,14201000,90452.22929936305,31,8509000
2019,county,48085,Collin,11001,District of Columbia,DC,D.C.,43,2921000,67930.23255813954,47,3214000,68382.97872340426,-4,-293000
2019,county,48439,Tarrant,35013,Dona Ana,NM,Rural New Mexico,75,1465000,19533.333333333332,47,1434000,30510.63829787234,28,31000
2019,county,48113,Dallas,35013,Dona Ana,NM,Rural New Mexico,40,899000,22475.0,51,1370000,26862.745098039217,-11,-471000
2019,county,48439,Tarrant,31055,Douglas,NE,Omaha,128,4851000,37898.4375,92,3457000,37576.086956521736,36,1394000
2019,county,48439,Tarrant,08035,Douglas,CO,Denver,122,6534000,53557.37704918033,213,18698000,87784.03755868545,-91,-12164000
2019,county,48113,Dallas,31055,Douglas,NE,Omaha,179,6498000,36301.675977653635,108,3525000,32638.88888888889,71,2973000
2019,county,48113,Dallas,08035,Douglas,CO,Denver,99,8921000,90111.11111111111,138,7234000,52420.289855072464,-39,1687000
2019,county,48121,Denton,08035,Douglas,CO,Denver,138,6605000,47862.31884057971,129,6313000,48937.98449612403,9,292000
2019,county,48121,Denton,31055,Douglas,NE,Omaha,90,2669000,29655.555555555555,58,3165000,54568.96551724138,32,-496000
2019,county,48085,Collin,08035,Douglas,CO,Denver,111,7581000,68297.2972972973,160,6278000,39237.5,-49,1303000
2019,county,48085,Collin,31055,Douglas,NE,Omaha,97,3467000,35742.26804123711,52,1915000,36826.92307692308,45,1552000
2019,county,48439,Tarrant,17043,DuPage,IL,Chicago,130,7214000,55492.307692307695,69,2504000,36289.85507246377,61,4710000
2019,county,48113,Dallas,17043,DuPage,IL,Chicago,215,11833000,55037.20930232558,133,6057000,45541.35338345865,82,5776000
2019,county,48121,Denton,17043,DuPage,IL,Chicago,133,6575000,49436.09022556391,36,2040000,56666.666666666664,97,4535000
2019,county,48085,Collin,17043,DuPage,IL,Chicago,288,14808000,51416.666666666664,96,4314000,44937.5,192,10494000
2019,county,48113,Dallas,37063,Durham,NC,Raleigh,100,4922000,49220.0,75,3966000,52880.0,25,956000
2019,county,48439,Tarrant,12031,Duval,FL,Jacksonville,203,3954000,19477.83251231527,169,4482000,26520.710059171597,34,-528000
2019,county,48113,Dallas,12031,Duval,FL,Jacksonville,221,7109000,32167.42081447964,172,6228000,36209.3023255814,49,881000
2019,county,48121,Denton,12031,Duval,FL,Jacksonville,109,3811000,34963.30275229358,66,2236000,33878.78787878788,43,1575000
2019,county,48085,Collin,12031,Duval,FL,Jacksonville,105,4267000,40638.09523809524,83,3244000,39084.33734939759,22,1023000
2019,county,48439,Tarrant,22033,East Baton Rouge Parish,LA,Rural Louisiana,224,5552000,24785.714285714286,80,1708000,21350.0,144,3844000
2019,county,48113,Dallas,22033,East Baton Rouge Parish,LA,Rural Louisiana,263,7920000,30114.06844106464,131,7187000,54862.59541984733,132,733000
2019,county,48121,Denton,22033,East Baton Rouge Parish,LA,Rural Louisiana,113,2764000,24460.17699115044,51,1834000,35960.78431372549,62,930000
2019,county,48085,Collin,22033,East Baton Rouge Parish,LA,Rural Louisiana,91,2226000,24461.53846153846,38,956000,25157.894736842107,53,1270000
2019,county,48439,Tarrant,48133,Eastland,TX,Rural Texas,34,927000,27264.70588235294,60,1349000,22483.333333333332,-26,-422000
2019,county,48439,Tarrant,48135,Ector,TX,Rural Texas,230,8062000,35052.17391304348,200,5095000,25475.0,30,2967000
2019,county,48113,Dallas,48135,Ector,TX,Rural Texas,150,5551000,37006.666666666664,155,3341000,21554.83870967742,-5,2210000
2019,county,48121,Denton,48135,Ector,TX,Rural Texas,113,4361000,38592.9203539823,41,1128000,27512.19512195122,72,3233000
2019,county,48085,Collin,48135,Ector,TX,Rural Texas,90,3046000,33844.444444444445,45,1126000,25022.222222222223,45,1920000
2019,county,48439,Tarrant,48141,El Paso,TX,El Paso,550,12984000,23607.272727272728,472,10561000,22375.0,78,2423000
2019,county,48439,Tarrant,08041,El Paso,CO,Colorado Springs,294,9012000,30653.061224489797,302,9486000,31410.596026490068,-8,-474000
2019,county,48113,Dallas,48141,El Paso,TX,El Paso,580,16354000,28196.55172413793,448,9249000,20645.089285714286,132,7105000
2019,county,48113,Dallas,08041,El Paso,CO,Colorado Springs,180,4738000,26322.222222222223,295,9390000,31830.508474576272,-115,-4652000
2019,county,48121,Denton,48141,El Paso,TX,El Paso,203,6861000,33798.02955665025,113,3106000,27486.725663716814,90,3755000
2019,county,48121,Denton,08041,El Paso,CO,Colorado Springs,140,4227000,30192.85714285714,118,3918000,33203.38983050847,22,309000
2019,county,48085,Collin,48141,El Paso,TX,El Paso,250,6694000,26776.0,145,3364000,23200.0,105,3330000
2019,county,48085,Collin,08041,El Paso,CO,Colorado Springs,157,5116000,32585.987261146496,164,6930000,42256.09756097561,-7,-1814000
2019,county,48439,Tarrant,48139,Ellis,TX,Dallas-Fort Worth,1303,37886000,29075.978511128167,2322,77345000,33309.646856158484,-1019,-39459000
2019,county,48113,Dallas,48139,Ellis,TX,Dallas-Fort Worth,2554,62478000,24462.803445575566,5478,158320000,28901.058780576852,-2924,-95842000
2019,county,48121,Denton,48139,Ellis,TX,Dallas-Fort Worth,328,10793000,32905.48780487805,323,11484000,35554.17956656347,5,-691000
2019,county,48085,Collin,48139,Ellis,TX,Dallas-Fort Worth,299,10725000,35869.565217391304,325,9210000,28338.46153846154,-26,1515000
2019,county,48439,Tarrant,48143,Erath,TX,Rural Texas,254,7616000,29984.251968503937,253,13237000,52320.1581027668,1,-5621000
2019,county,48113,Dallas,48143,Erath,TX,Rural Texas,73,1575000,21575.342465753423,59,1710000,28983.050847457627,14,-135000
2019,county,48439,Tarrant,36029,Erie,NY,Buffalo,71,2013000,28352.11267605634,46,1244000,27043.478260869564,25,769000
2019,county,48113,Dallas,36029,Erie,NY,Buffalo,58,2416000,41655.1724137931,64,1572000,24562.5,-6,844000
2019,county,48439,Tarrant,12033,Escambia,FL,FL Panhandle,83,1513000,18228.9156626506,98,2762000,28183.673469387755,-15,-1249000
2019,county,48113,Dallas,12033,Escambia,FL,FL Panhandle,64,2150000,33593.75,62,1581000,25500.0,2,569000
2019,county,48113,Dallas,34013,Essex,NJ,New York,76,3511000,46197.36842105263,48,5265000,109687.5,28,-1754000
2019,county,48113,Dallas,25009,Essex,MA,Boston,43,3332000,77488.37209302325,54,1255000,23240.74074074074,-11,2077000
2019,county,48439,Tarrant,51059,Fairfax,VA,D.C.,149,6897000,46288.590604026846,137,4478000,32686.131386861314,12,2419000
2019,county,48113,Dallas,51059,Fairfax,VA,D.C.,289,16247000,56217.993079584776,249,17470000,70160.64257028112,40,-1223000
2019,county,48121,Denton,51059,Fairfax,VA,D.C.,189,7790000,41216.93121693122,81,4659000,57518.51851851852,108,3131000
2019,county,48085,Collin,51059,Fairfax,VA,D.C.,290,16150000,55689.65517241379,141,6769000,48007.09219858156,149,9381000
2019,county,48439,Tarrant,09001,Fairfield,CT,New York,109,5852000,53688.07339449541,48,4958000,103291.66666666667,61,894000
2019,county,48113,Dallas,09001,Fairfield,CT,New York,139,14746000,106086.3309352518,74,6622000,89486.48648648648,65,8124000
2019,county,48085,Collin,09001,Fairfield,CT,New York,180,10237000,56872.22222222222,48,5053000,105270.83333333333,132,5184000
2019,county,48439,Tarrant,48147,Fannin,TX,Rural Texas,50,1215000,24300.0,75,2562000,34160.0,-25,-1347000
2019,county,48113,Dallas,48147,Fannin,TX,Rural Texas,75,1906000,25413.333333333332,138,3773000,27340.579710144928,-63,-1867000
2019,county,48121,Denton,48147,Fannin,TX,Rural Texas,93,1948000,20946.236559139787,73,2261000,30972.602739726026,20,-313000
2019,county,48085,Collin,48147,Fannin,TX,Rural Texas,275,6586000,23949.090909090908,453,13862000,30600.441501103753,-178,-7276000
2019,county,48113,Dallas,05045,Faulkner,AR,Little Rock,42,1216000,28952.380952380954,39,698000,17897.4358974359,3,518000
2019,county,48439,Tarrant,21067,Fayette,KY,Lexington,48,1384000,28833.333333333332,32,1207000,37718.75,16,177000
2019,county,48113,Dallas,13117,Forsyth,GA,Atlanta,42,1782000,42428.57142857143,67,4058000,60567.164179104475,-25,-2276000
2019,county,48085,Collin,13117,Forsyth,GA,Atlanta,70,4254000,60771.42857142857,54,2310000,42777.77777777778,16,1944000
2019,county,48439,Tarrant,48157,Fort Bend,TX,Houston,354,16559000,46776.83615819209,331,14193000,42879.15407854985,23,2366000
2019,county,48113,Dallas,48157,Fort Bend,TX,Houston,391,22604000,57810.74168797954,459,16421000,35775.59912854031,-68,6183000
2019,county,48121,Denton,48157,Fort Bend,TX,Houston,228,13019000,57100.87719298246,233,9049000,38836.909871244636,-5,3970000
2019,county,48085,Collin,48157,Fort Bend,TX,Houston,388,17008000,43835.051546391755,265,10235000,38622.64150943396,123,6773000
2019,county,48439,Tarrant,39049,Franklin,OH,Columbus,129,5216000,40434.108527131786,196,5068000,25857.14285714286,-67,148000
2019,county,48113,Dallas,39049,Franklin,OH,Columbus,244,10336000,42360.65573770492,222,7495000,33761.261261261265,22,2841000
2019,county,48121,Denton,39049,Franklin,OH,Columbus,98,4002000,40836.73469387755,56,2280000,40714.28571428572,42,1722000
2019,county,48085,Collin,39049,Franklin,OH,Columbus,162,9943000,61376.543209876545,91,3351000,36824.17582417582,71,6592000
2019,county,48113,Dallas,48161,Freestone,TX,Rural Texas,50,637000,12740.0,61,2279000,37360.65573770492,-11,-1642000
2019,county,48439,Tarrant,06019,Fresno,CA,Fresno,109,2779000,25495.4128440367,81,2014000,24864.197530864196,28,765000
2019,county,48113,Dallas,06019,Fresno,CA,Fresno,80,4058000,50725.0,67,1715000,25597.014925373136,13,2343000
2019,county,48439,Tarrant,13121,Fulton,GA,Atlanta,166,12246000,73771.0843373494,174,8412000,48344.8275862069,-8,3834000
2019,county,48113,Dallas,13121,Fulton,GA,Atlanta,404,32434000,80282.17821782178,414,26357000,63664.25120772947,-10,6077000
2019,county,48121,Denton,13121,Fulton,GA,Atlanta,142,10584000,74535.21126760563,81,4845000,59814.81481481482,61,5739000
2019,county,48085,Collin,13121,Fulton,GA,Atlanta,274,11982000,43729.92700729927,238,14452000,60722.68907563025,36,-2470000
2019,county,48439,Tarrant,48167,Galveston,TX,Houston,145,5518000,38055.1724137931,164,5709000,34810.9756097561,-19,-191000
2019,county,48113,Dallas,48167,Galveston,TX,Houston,161,5351000,33236.024844720494,193,6731000,34875.64766839378,-32,-1380000
2019,county,48121,Denton,48167,Galveston,TX,Houston,79,3841000,48620.25316455696,90,2995000,33277.77777777778,-11,846000
2019,county,48085,Collin,48167,Galveston,TX,Houston,106,5226000,49301.88679245283,79,4391000,55582.27848101266,27,835000
2019,county,48113,Dallas,05051,Garland,AR,Rural Arkansas,41,1091000,26609.756097560974,51,2666000,52274.509803921566,-10,-1575000
2019,county,48439,Tarrant,26049,Genesee,MI,Rural Michigan,110,1701000,15463.636363636364,61,956000,15672.131147540984,49,745000
2019,county,48439,Tarrant,48181,Grayson,TX,Rural Texas,219,6173000,28187.214611872147,304,8958000,29467.105263157893,-85,-2785000
2019,county,48113,Dallas,48181,Grayson,TX,Rural Texas,357,10886000,30492.99719887955,641,17838000,27828.39313572543,-284,-6952000
2019,county,48121,Denton,48181,Grayson,TX,Rural Texas,514,16149000,31418.28793774319,849,29837000,35143.69846878681,-335,-13688000
2019,county,48085,Collin,48181,Grayson,TX,Rural Texas,1000,37946000,37946.0,1924,65612000,34101.871101871104,-924,-27666000
2019,county,48439,Tarrant,29077,Greene,MO,Rural Missouri,55,972000,17672.727272727272,49,1961000,40020.4081632653,6,-989000
2019,county,48113,Dallas,29077,Greene,MO,Rural Missouri,49,1522000,31061.224489795917,50,978000,19560.0,-1,544000
2019,county,48085,Collin,29077,Greene,MO,Rural Missouri,36,1129000,31361.11111111111,46,1706000,37086.95652173913,-10,-577000
2019,county,48113,Dallas,45045,Greenville,SC,Greenville,74,5273000,71256.75675675676,87,4660000,53563.2183908046,-13,613000
2019,county,48439,Tarrant,48183,Gregg,TX,Rural Texas,221,5671000,25660.633484162896,121,4289000,35446.28099173554,100,1382000
2019,county,48113,Dallas,48183,Gregg,TX,Rural Texas,322,6898000,21422.360248447207,279,5923000,21229.390681003584,43,975000
2019,county,48121,Denton,48183,Gregg,TX,Rural Texas,68,1911000,28102.941176470587,68,2123000,31220.58823529412,0,-212000
2019,county,48085,Collin,48183,Gregg,TX,Rural Texas,133,3377000,25390.977443609023,71,1690000,23802.816901408452,62,1687000
2019,county,48439,Tarrant,48187,Guadalupe,TX,San Antonio,107,3714000,34710.280373831774,117,3378000,28871.79487179487,-10,336000
2019,county,48113,Dallas,48187,Guadalupe,TX,San Antonio,70,3293000,47042.857142857145,87,2820000,32413.793103448275,-17,473000
2019,county,48121,Denton,48187,Guadalupe,TX,San Antonio,43,1681000,39093.023255813954,62,1544000,24903.225806451614,-19,137000
2019,county,48439,Tarrant,37081,Guilford,NC,Greensboro,93,3890000,41827.95698924731,35,1648000,47085.71428571428,58,2242000
2019,county,48113,Dallas,37081,Guilford,NC,Greensboro,66,2254000,34151.51515151515,55,1849000,33618.181818181816,11,405000
2019,county,48439,Tarrant,13135,Gwinnett,GA,Atlanta,126,4139000,32849.206349206346,157,3149000,20057.32484076433,-31,990000
2019,county,48113,Dallas,13135,Gwinnett,GA,Atlanta,150,7466000,49773.333333333336,127,3343000,26322.834645669293,23,4123000
2019,county,48121,Denton,13135,Gwinnett,GA,Atlanta,97,4000000,41237.113402061856,56,2356000,42071.42857142857,41,1644000
2019,county,48085,Collin,13135,Gwinnett,GA,Atlanta,135,5757000,42644.444444444445,82,2919000,35597.560975609755,53,2838000
2019,county,48439,Tarrant,39061,Hamilton,OH,Cincinnati,50,1887000,37740.0,73,1917000,26260.27397260274,-23,-30000
2019,county,48439,Tarrant,18057,Hamilton,IN,Indianapolis,49,1993000,40673.4693877551,60,4137000,68950.0,-11,-2144000
2019,county,48113,Dallas,39061,Hamilton,OH,Cincinnati,83,4145000,49939.75903614458,108,4703000,43546.2962962963,-25,-558000
2019,county,48113,Dallas,18057,Hamilton,IN,Indianapolis,46,6121000,133065.21739130435,48,4182000,87125.0,-2,1939000
2019,county,48439,Tarrant,48201,Harris,TX,Houston,2210,95575000,43246.60633484163,1987,79475000,39997.48364368395,223,16100000
2019,county,48113,Dallas,48201,Harris,TX,Houston,3458,195082000,56414.69057258531,3052,133285000,43671.3630406291,406,61797000
2019,county,48121,Denton,48201,Harris,TX,Houston,1064,46298000,43513.15789473684,776,27176000,35020.61855670103,288,19122000
2019,county,48085,Collin,48201,Harris,TX,Houston,1241,52123000,42000.80580177277,916,43760000,47772.92576419214,325,8363000
2019,county,48439,Tarrant,48203,Harrison,TX,Rural Texas,89,2271000,25516.85393258427,82,2577000,31426.829268292684,7,-306000
2019,county,48113,Dallas,48203,Harrison,TX,Rural Texas,183,2998000,16382.513661202185,114,2326000,20403.508771929824,69,672000
2019,county,48113,Dallas,28047,Harrison,MS,Gulfport-Biloxi,44,1089000,24750.0,66,1773000,26863.636363636364,-22,-684000
2019,county,48121,Denton,48203,Harrison,TX,Rural Texas,45,1416000,31466.666666666668,36,710000,19722.222222222223,9,706000
2019,county,48113,Dallas,09003,Hartford,CT,Hartford,70,2955000,42214.28571428572,60,3352000,55866.666666666664,10,-397000
2019,county,48121,Denton,09003,Hartford,CT,Hartford,43,2582000,60046.51162790698,35,1706000,48742.857142857145,8,876000
2019,county,48439,Tarrant,48209,Hays,TX,Austin,151,4178000,27668.87417218543,188,8925000,47473.40425531915,-37,-4747000
2019,county,48113,Dallas,48209,Hays,TX,Austin,191,5363000,28078.534031413612,198,9654000,48757.57575757576,-7,-4291000
2019,county,48121,Denton,48209,Hays,TX,Austin,111,3855000,34729.72972972973,108,4101000,37972.22222222222,3,-246000
2019,county,48085,Collin,48209,Hays,TX,Austin,73,2341000,32068.49315068493,134,8687000,64828.35820895522,-61,-6346000
2019,county,48439,Tarrant,48213,Henderson,TX,Rural Texas,168,4163000,24779.761904761905,213,7038000,33042.25352112676,-45,-2875000
2019,county,48113,Dallas,48213,Henderson,TX,Rural Texas,294,10868000,36965.986394557825,616,18213000,29566.55844155844,-322,-7345000
2019,county,48121,Denton,48213,Henderson,TX,Rural Texas,104,5722000,55019.230769230766,86,4175000,48546.51162790698,18,1547000
2019,county,48085,Collin,48213,Henderson,TX,Rural Texas,112,5267000,47026.78571428572,158,7151000,45259.49367088608,-46,-1884000
2019,county,48439,Tarrant,27053,Hennepin,MN,Minneapolis,191,8436000,44167.53926701571,152,6760000,44473.68421052631,39,1676000
2019,county,48113,Dallas,27053,Hennepin,MN,Minneapolis,242,23378000,96603.30578512397,182,8842000,48582.41758241758,60,14536000
2019,county,48121,Denton,27053,Hennepin,MN,Minneapolis,123,6200000,50406.50406504065,63,3175000,50396.8253968254,60,3025000
2019,county,48085,Collin,27053,Hennepin,MN,Minneapolis,224,14090000,62901.78571428572,105,5828000,55504.76190476191,119,8262000
2019,county,48113,Dallas,51087,Henrico,VA,Richmond,58,2789000,48086.206896551725,71,4321000,60859.15492957747,-13,-1532000
2019,county,48085,Collin,51087,Henrico,VA,Richmond,62,2379000,38370.967741935485,84,4092000,48714.28571428572,-22,-1713000
2019,county,48439,Tarrant,48215,Hidalgo,TX,Rural Texas,210,3873000,18442.85714285714,195,3467000,17779.48717948718,15,406000
2019,county,48113,Dallas,48215,Hidalgo,TX,Rural Texas,372,7699000,20696.236559139787,352,6293000,17877.840909090908,20,1406000
2019,county,48121,Denton,48215,Hidalgo,TX,Rural Texas,90,2510000,27888.88888888889,59,1108000,18779.661016949154,31,1402000
2019,county,48085,Collin,48215,Hidalgo,TX,Rural Texas,112,2801000,25008.928571428572,69,1719000,24913.043478260868,43,1082000
2019,county,48439,Tarrant,48217,Hill,TX,Rural Texas,144,3412000,23694.444444444445,271,8294000,30605.166051660515,-127,-4882000
2019,county,48113,Dallas,48217,Hill,TX,Rural Texas,89,2008000,22561.79775280899,124,3634000,29306.451612903227,-35,-1626000
2019,county,48439,Tarrant,12057,Hillsborough,FL,Tampa,157,6077000,38707.00636942675,229,6014000,26262.008733624454,-72,63000
2019,county,48113,Dallas,12057,Hillsborough,FL,Tampa,280,11465000,40946.42857142857,255,14464000,56721.56862745098,25,-2999000
2019,county,48121,Denton,12057,Hillsborough,FL,Tampa,138,8487000,61500.0,108,4684000,43370.37037037037,30,3803000
2019,county,48085,Collin,12057,Hillsborough,FL,Tampa,220,9815000,44613.63636363636,188,10201000,54260.63829787234,32,-386000
2019,county,48439,Tarrant,28049,Hinds,MS,Jackson,297,4206000,14161.61616161616,91,1095000,12032.967032967033,206,3111000
2019,county,48113,Dallas,28049,Hinds,MS,Jackson,269,4622000,17182.156133828998,61,1609000,26377.049180327867,208,3013000
2019,county,48439,Tarrant,15003,Honolulu,HI,Rural Hawaii,237,6466000,27282.70042194093,133,3686000,27714.285714285714,104,2780000
2019,county,48113,Dallas,15003,Honolulu,HI,Rural Hawaii,186,6365000,34220.43010752688,110,3553000,32300.0,76,2812000
2019,county,48121,Denton,15003,Honolulu,HI,Rural Hawaii,90,2910000,32333.333333333332,38,1336000,35157.89473684211,52,1574000
2019,county,48085,Collin,15003,Honolulu,HI,Rural Hawaii,155,4874000,31445.16129032258,53,2123000,40056.6037735849,102,2751000
2019,county,48439,Tarrant,48221,Hood,TX,Rural Texas,716,29061000,40587.98882681564,1157,42932000,37106.309420916165,-441,-13871000
2019,county,48113,Dallas,48221,Hood,TX,Rural Texas,96,2992000,31166.666666666668,160,5848000,36550.0,-64,-2856000
2019,county,48121,Denton,48221,Hood,TX,Rural Texas,104,3588000,34500.0,115,5828000,50678.260869565216,-11,-2240000
2019,county,48085,Collin,48221,Hood,TX,Rural Texas,50,1298000,25960.0,39,2009000,51512.820512820515,11,-711000
2019,county,48439,Tarrant,48223,Hopkins,TX,Rural Texas,41,885000,21585.365853658535,43,1401000,32581.39534883721,-2,-516000
2019,county,48113,Dallas,48223,Hopkins,TX,Rural Texas,95,2614000,27515.78947368421,144,3261000,22645.833333333332,-49,-647000
2019,county,48121,Denton,48223,Hopkins,TX,Rural Texas,34,1046000,30764.70588235294,32,825000,25781.25,2,221000
2019,county,48085,Collin,48223,Hopkins,TX,Rural Texas,62,1688000,27225.8064516129,69,2603000,37724.637681159424,-7,-915000
2019,county,48439,Tarrant,48227,Howard,TX,Rural Texas,66,1969000,29833.333333333332,60,1884000,31400.0,6,85000
2019,county,48113,Dallas,24027,Howard,MD,Baltimore,62,3469000,55951.6129032258,43,2180000,50697.67441860465,19,1289000
2019,county,48439,Tarrant,34017,Hudson,NJ,New York,118,3441000,29161.01694915254,46,2092000,45478.260869565216,72,1349000
2019,county,48113,Dallas,34017,Hudson,NJ,New York,210,10532000,50152.380952380954,141,8092000,57390.07092198582,69,2440000
2019,county,48121,Denton,34017,Hudson,NJ,New York,56,3225000,57589.28571428572,47,3075000,65425.53191489362,9,150000
2019,county,48085,Collin,34017,Hudson,NJ,New York,165,8503000,51533.333333333336,75,4590000,61200.0,90,3913000
2019,county,48439,Tarrant,48231,Hunt,TX,Dallas-Fort Worth,151,3667000,24284.76821192053,222,5092000,22936.936936936938,-71,-1425000
2019,county,48113,Dallas,48231,Hunt,TX,Dallas-Fort Worth,812,18116000,22310.344827586207,1425,31351000,22000.701754385966,-613,-13235000
2019,county,48121,Denton,48231,Hunt,TX,Dallas-Fort Worth,145,3052000,21048.275862068964,185,5634000,30454.054054054053,-40,-2582000
2019,county,48085,Collin,48231,Hunt,TX,Dallas-Fort Worth,605,14224000,23510.743801652894,919,24893000,27087.051142546246,-314,-10669000
2019,county,48439,Tarrant,29095,Jackson,MO,Kansas City,240,5297000,22070.833333333332,168,4566000,27178.571428571428,72,731000
2019,county,48113,Dallas,29095,Jackson,MO,Kansas City,265,9492000,35818.8679245283,224,9725000,43415.17857142857,41,-233000
2019,county,48085,Collin,29095,Jackson,MO,Kansas City,121,5955000,49214.87603305785,42,2127000,50642.857142857145,79,3828000
2019,county,48439,Tarrant,48245,Jefferson,TX,Rural Texas,163,4275000,26226.993865030676,139,3071000,22093.525179856115,24,1204000
2019,county,48439,Tarrant,08059,Jefferson,CO,Denver,105,4207000,40066.666666666664,150,8310000,55400.0,-45,-4103000
2019,county,48439,Tarrant,21111,Jefferson,KY,Louisville,101,3531000,34960.39603960396,111,2928000,26378.37837837838,-10,603000
2019,county,48439,Tarrant,01073,Jefferson,AL,Birmingham,82,2713000,33085.365853658535,79,1914000,24227.848101265823,3,799000
2019,county,48113,Dallas,48245,Jefferson,TX,Rural Texas,129,6157000,47728.682170542634,138,2517000,18239.130434782608,-9,3640000
2019,county,48113,Dallas,01073,Jefferson,AL,Birmingham,113,5471000,48415.929203539825,104,4643000,44644.230769230766,9,828000
2019,county,48113,Dallas,08059,Jefferson,CO,Denver,98,3883000,39622.448979591834,164,11592000,70682.9268292683,-66,-7709000
2019,county,48113,Dallas,21111,Jefferson,KY,Louisville,116,4285000,36939.65517241379,90,4988000,55422.22222222222,26,-703000
2019,county,48121,Denton,08059,Jefferson,CO,Denver,88,3121000,35465.90909090909,70,4485000,64071.42857142857,18,-1364000
2019,county,48085,Collin,21111,Jefferson,KY,Louisville,101,4400000,43564.35643564357,43,1880000,43720.93023255814,58,2520000
2019,county,48085,Collin,08059,Jefferson,CO,Denver,75,4692000,62560.0,86,5899000,68593.02325581395,-11,-1207000
2019,county,48085,Collin,01073,Jefferson,AL,Birmingham,41,1587000,38707.31707317073,40,1439000,35975.0,1,148000
2019,county,48439,Tarrant,22051,Jefferson Parish,LA,New Orleans,133,3019000,22699.248120300752,54,1112000,20592.59259259259,79,1907000
2019,county,48113,Dallas,22051,Jefferson Parish,LA,New Orleans,170,6901000,40594.117647058825,79,1363000,17253.164556962027,91,5538000
2019,county,48439,Tarrant,48251,Johnson,TX,Dallas-Fort Worth,4282,112283000,26222.092480149462,6619,185145000,27971.74799818704,-2337,-72862000
2019,county,48439,Tarrant,20091,Johnson,KS,Kansas City,165,8820000,53454.545454545456,152,6697000,44059.21052631579,13,2123000
2019,county,48113,Dallas,48251,Johnson,TX,Dallas-Fort Worth,453,11095000,24492.273730684326,894,25435000,28450.782997762864,-441,-14340000
2019,county,48113,Dallas,20091,Johnson,KS,Kansas City,217,14923000,68769.58525345621,154,7338000,47649.35064935065,63,7585000
2019,county,48121,Denton,48251,Johnson,TX,Dallas-Fort Worth,175,5948000,33988.57142857143,237,6364000,26852.320675105486,-62,-416000
2019,county,48121,Denton,20091,Johnson,KS,Kansas City,146,7622000,52205.479452054795,65,2954000,45446.153846153844,81,4668000
2019,county,48085,Collin,20091,Johnson,KS,Kansas City,250,11065000,44260.0,139,6200000,44604.31654676259,111,4865000
2019,county,48085,Collin,48251,Johnson,TX,Dallas-Fort Worth,116,3289000,28353.44827586207,134,4205000,31380.597014925374,-18,-916000
2019,county,48439,Tarrant,17089,Kane,IL,Chicago,116,4114000,35465.51724137931,39,1561000,40025.64102564102,77,2553000
2019,county,48113,Dallas,17089,Kane,IL,Chicago,70,2408000,34400.0,60,1110000,18500.0,10,1298000
2019,county,48439,Tarrant,48257,Kaufman,TX,Dallas-Fort Worth,364,9500000,26098.9010989011,612,14625000,23897.058823529413,-248,-5125000
2019,county,48113,Dallas,48257,Kaufman,TX,Dallas-Fort Worth,2703,61980000,22930.07769145394,7363,164888000,22394.13282629363,-4660,-102908000
2019,county,48121,Denton,48257,Kaufman,TX,Dallas-Fort Worth,265,8943000,33747.16981132075,353,11727000,33220.963172804535,-88,-2784000
2019,county,48085,Collin,48257,Kaufman,TX,Dallas-Fort Worth,493,15693000,31831.6430020284,642,19667000,30633.956386292833,-149,-3974000
2019,county,48113,Dallas,48259,Kendall,TX,Rural Texas,31,1355000,43709.67741935484,36,1813000,50361.11111111111,-5,-458000
2019,county,48439,Tarrant,26081,Kent,MI,Rural Michigan,74,1710000,23108.108108108107,55,1580000,28727.272727272728,19,130000
2019,county,48113,Dallas,26081,Kent,MI,Rural Michigan,85,2841000,33423.529411764706,53,1207000,22773.584905660377,32,1634000
2019,county,48439,Tarrant,06029,Kern,CA,Rural California,168,4429000,26363.095238095237,50,1283000,25660.0,118,3146000
2019,county,48113,Dallas,06029,Kern,CA,Rural California,44,1059000,24068.18181818182,45,1489000,33088.88888888889,-1,-430000
2019,county,48439,Tarrant,53033,King,WA,Seattle,294,15893000,54057.8231292517,298,18383000,61687.91946308725,-4,-2490000
2019,county,48113,Dallas,53033,King,WA,Seattle,504,44198000,87694.44444444444,660,44913000,68050.0,-156,-715000
2019,county,48121,Denton,53033,King,WA,Seattle,160,9771000,61068.75,229,12037000,52563.318777292574,-69,-2266000
2019,county,48085,Collin,53033,King,WA,Seattle,508,31556000,62118.11023622047,579,33592000,58017.27115716753,-71,-2036000
2019,county,48439,Tarrant,36047,Kings,NY,New York,158,5246000,33202.53164556962,78,2733000,35038.46153846154,80,2513000
2019,county,48113,Dallas,36047,Kings,NY,New York,237,12580000,53080.168776371305,209,10958000,52430.62200956938,28,1622000
2019,county,48121,Denton,36047,Kings,NY,New York,78,3100000,39743.58974358974,33,1434000,43454.545454545456,45,1666000
2019,county,48085,Collin,36047,Kings,NY,New York,147,4894000,33292.51700680272,75,2979000,39720.0,72,1915000
2019,county,48113,Dallas,53035,Kitsap,WA,Rural Washington,44,1403000,31886.363636363636,36,943000,26194.444444444445,8,460000
2019,county,48439,Tarrant,47093,Knox,TN,Knoxville,67,1996000,29791.044776119405,72,2326000,32305.555555555555,-5,-330000
2019,county,48113,Dallas,47093,Knox,TN,Knoxville,38,1633000,42973.68421052631,36,1376000,38222.22222222222,2,257000
2019,county,48439,Tarrant,22055,Lafayette Parish,LA,Rural Louisiana,83,2413000,29072.289156626506,41,756000,18439.024390243903,42,1657000
2019,county,48113,Dallas,22055,Lafayette Parish,LA,Rural Louisiana,90,2475000,27500.0,63,1398000,22190.47619047619,27,1077000
2019,county,48439,Tarrant,17097,Lake,IL,Chicago,135,4493000,33281.48148148148,63,2228000,35365.079365079364,72,2265000
2019,county,48113,Dallas,17097,Lake,IL,Chicago,149,12659000,84959.73154362416,65,2125000,32692.30769230769,84,10534000
2019,county,48113,Dallas,18089,Lake,IN,Rural Indiana,63,1355000,21507.93650793651,55,1070000,19454.545454545456,8,285000
2019,county,48121,Denton,17097,Lake,IL,Chicago,89,4473000,50258.426966292136,36,2234000,62055.555555555555,53,2239000
2019,county,48439,Tarrant,48277,Lamar,TX,Rural Texas,41,1172000,28585.365853658535,55,1377000,25036.363636363636,-14,-205000
2019,county,48113,Dallas,48277,Lamar,TX,Rural Texas,136,1860000,13676.470588235294,166,3874000,23337.349397590362,-30,-2014000
2019,county,48121,Denton,48277,Lamar,TX,Rural Texas,47,1065000,22659.574468085106,57,1143000,20052.63157894737,-10,-78000
2019,county,48085,Collin,48277,Lamar,TX,Rural Texas,80,1937000,24212.5,70,2247000,32100.0,10,-310000
2019,county,48439,Tarrant,31109,Lancaster,NE,Rural Nebraska,57,1613000,28298.245614035088,41,1184000,28878.048780487807,16,429000
2019,county,48439,Tarrant,08069,Larimer,CO,Rural Colorado,45,1017000,22600.0,120,4664000,38866.666666666664,-75,-3647000
2019,county,48113,Dallas,08069,Larimer,CO,Rural Colorado,34,1671000,49147.05882352941,70,4225000,60357.142857142855,-36,-2554000
2019,county,48085,Collin,08069,Larimer,CO,Rural Colorado,49,2160000,44081.63265306123,70,3800000,54285.71428571428,-21,-1640000
2019,county,48439,Tarrant,12071,Lee,FL,S.W. Florida,97,3041000,31350.515463917527,79,4693000,59405.06329113924,18,-1652000
2019,county,48113,Dallas,12071,Lee,FL,S.W. Florida,96,7219000,75197.91666666667,76,3180000,41842.10526315789,20,4039000
2019,county,48121,Denton,12071,Lee,FL,S.W. Florida,79,3764000,47645.56962025316,52,2916000,56076.92307692308,27,848000
2019,county,48085,Collin,12071,Lee,FL,S.W. Florida,50,2617000,52340.0,49,6968000,142204.08163265305,1,-4351000
2019,county,48113,Dallas,48293,Limestone,TX,Rural Texas,35,567000,16200.0,48,932000,19416.666666666668,-13,-365000
2019,county,48439,Tarrant,06037,Los Angeles,CA,Los Angeles,1368,42916000,31371.345029239765,579,31722000,54787.56476683938,789,11194000
2019,county,48113,Dallas,06037,Los Angeles,CA,Los Angeles,1539,75894000,49313.84015594542,1114,111876000,100427.28904847396,425,-35982000
2019,county,48121,Denton,06037,Los Angeles,CA,Los Angeles,790,53477000,67692.40506329114,299,14886000,49785.95317725753,491,38591000
2019,county,48085,Collin,06037,Los Angeles,CA,Los Angeles,1246,47905000,38447.03049759229,476,22098000,46424.36974789916,770,25807000
2019,county,48439,Tarrant,51107,Loudoun,VA,Rural Virginia,49,3245000,66224.48979591837,54,2494000,46185.18518518518,-5,751000
2019,county,48113,Dallas,51107,Loudoun,VA,Rural Virginia,59,5313000,90050.84745762713,103,6119000,59407.76699029126,-44,-806000
2019,county,48085,Collin,51107,Loudoun,VA,Rural Virginia,127,8090000,63700.7874015748,82,3432000,41853.65853658537,45,4658000
2019,county,48121,Denton,40085,Love,OK,Rural Oklahoma,38,870000,22894.736842105263,45,2439000,54200.0,-7,-1569000
2019,county,48439,Tarrant,48303,Lubbock,TX,Rural Texas,545,13422000,24627.522935779816,371,10126000,27293.800539083557,174,3296000
2019,county,48113,Dallas,48303,Lubbock,TX,Rural Texas,479,13331000,27830.89770354906,329,7885000,23966.565349544075,150,5446000
2019,county,48121,Denton,48303,Lubbock,TX,Rural Texas,234,6107000,26098.290598290598,169,5618000,33242.603550295855,65,489000
2019,county,48085,Collin,48303,Lubbock,TX,Rural Texas,289,10968000,37951.5570934256,164,4719000,28774.39024390244,125,6249000
2019,county,48439,Tarrant,26099,Macomb,MI,Rural Michigan,107,2909000,27186.915887850468,40,1813000,45325.0,67,1096000
2019,county,48113,Dallas,26099,Macomb,MI,Rural Michigan,48,1773000,36937.5,36,2055000,57083.333333333336,12,-282000
2019,county,48439,Tarrant,01089,Madison,AL,Huntsville,60,2038000,33966.666666666664,59,2553000,43271.186440677964,1,-515000
2019,county,48113,Dallas,01089,Madison,AL,Huntsville,61,1699000,27852.45901639344,43,2133000,49604.651162790695,18,-434000
2019,county,48113,Dallas,28089,Madison,MS,Jackson,57,2321000,40719.29824561404,37,1362000,36810.81081081081,20,959000
2019,county,48439,Tarrant,04013,Maricopa,AZ,Phoenix,777,45605000,58693.69369369369,704,33957000,48234.375,73,11648000
2019,county,48113,Dallas,04013,Maricopa,AZ,Phoenix,778,55395000,71201.79948586118,814,52128000,64039.31203931204,-36,3267000
2019,county,48121,Denton,04013,Maricopa,AZ,Phoenix,437,19172000,43871.85354691075,409,21377000,52266.503667481666,28,-2205000
2019,county,48085,Collin,04013,Maricopa,AZ,Phoenix,619,36793000,59439.418416801294,563,26542000,47143.872113676734,56,10251000
2019,county,48439,Tarrant,18097,Marion,IN,Indianapolis,166,4878000,29385.5421686747,97,2289000,23597.938144329895,69,2589000
2019,county,48113,Dallas,18097,Marion,IN,Indianapolis,196,6092000,31081.632653061224,139,3278000,23582.733812949642,57,2814000
2019,county,48121,Denton,18097,Marion,IN,Indianapolis,70,2737000,39100.0,66,1445000,21893.939393939392,4,1292000
2019,county,48085,Collin,18097,Marion,IN,Indianapolis,76,2636000,34684.21052631579,47,1752000,37276.59574468085,29,884000
2019,county,48085,Collin,17113,McLean,IL,Rural Illinois,208,10351000,49764.42307692308,52,2637000,50711.53846153846,156,7714000
2019,county,48439,Tarrant,48309,McLennan,TX,Rural Texas,562,14513000,25823.843416370106,421,10804000,25662.70783847981,141,3709000
2019,county,48113,Dallas,48309,McLennan,TX,Rural Texas,573,13905000,24267.015706806284,456,12306000,26986.842105263157,117,1599000
2019,county,48121,Denton,48309,McLennan,TX,Rural Texas,176,3668000,20840.909090909092,150,3885000,25900.0,26,-217000
2019,county,48085,Collin,48309,McLennan,TX,Rural Texas,196,7571000,38627.551020408166,140,4838000,34557.142857142855,56,2733000
2019,county,48439,Tarrant,37119,Mecklenburg,NC,Charlotte,168,9242000,55011.90476190476,186,6181000,33231.18279569892,-18,3061000
2019,county,48113,Dallas,37119,Mecklenburg,NC,Charlotte,327,23334000,71357.79816513762,305,17421000,57118.03278688525,22,5913000
2019,county,48121,Denton,37119,Mecklenburg,NC,Charlotte,89,4770000,53595.50561797753,110,4603000,41845.454545454544,-21,167000
2019,county,48085,Collin,37119,Mecklenburg,NC,Charlotte,214,8361000,39070.09345794393,159,11891000,74786.16352201258,55,-3530000
2019,county,48113,Dallas,34021,Mercer,NJ,Rural New Jersey,29,1616000,55724.137931034486,38,1559000,41026.31578947369,-9,57000
2019,county,48439,Tarrant,12086,Miami-Dade,FL,Miami,283,7227000,25537.102473498235,186,6377000,34284.94623655914,97,850000
2019,county,48113,Dallas,12086,Miami-Dade,FL,Miami,541,42508000,78573.01293900186,362,33403000,92273.48066298342,179,9105000
2019,county,48121,Denton,12086,Miami-Dade,FL,Miami,230,7222000,31400.0,89,4638000,52112.3595505618,141,2584000
2019,county,48085,Collin,12086,Miami-Dade,FL,Miami,245,8284000,33812.244897959186,124,5730000,46209.67741935484,121,2554000
2019,county,48439,Tarrant,25017,Middlesex,MA,Boston,86,5442000,63279.06976744186,88,4214000,47886.36363636364,-2,1228000
2019,county,48113,Dallas,25017,Middlesex,MA,Boston,238,18309000,76928.57142857143,158,11123000,70398.73417721518,80,7186000
2019,county,48113,Dallas,34023,Middlesex,NJ,New York,234,10848000,46358.97435897436,141,4751000,33695.035460992905,93,6097000
2019,county,48121,Denton,25017,Middlesex,MA,Boston,85,4562000,53670.58823529412,56,2926000,52250.0,29,1636000
2019,county,48085,Collin,34023,Middlesex,NJ,New York,348,14866000,42718.3908045977,111,3724000,33549.54954954955,237,11142000
2019,county,48085,Collin,25017,Middlesex,MA,Boston,146,8734000,59821.91780821918,107,7310000,68317.75700934579,39,1424000
2019,county,48439,Tarrant,48329,Midland,TX,Rural Texas,460,20387000,44319.565217391304,237,12389000,52274.261603375526,223,7998000
2019,county,48113,Dallas,48329,Midland,TX,Rural Texas,300,39870000,132900.0,215,8927000,41520.93023255814,85,30943000
2019,county,48121,Denton,48329,Midland,TX,Rural Texas,140,11902000,85014.28571428571,107,3132000,29271.028037383177,33,8770000
2019,county,48085,Collin,48329,Midland,TX,Rural Texas,148,9970000,67364.86486486487,57,2525000,44298.245614035084,91,7445000
2019,county,48439,Tarrant,55079,Milwaukee,WI,Milwaukee,218,5604000,25706.422018348625,79,1467000,18569.620253164558,139,4137000
2019,county,48113,Dallas,55079,Milwaukee,WI,Milwaukee,226,5763000,25500.0,131,3504000,26748.091603053435,95,2259000
2019,county,48121,Denton,55079,Milwaukee,WI,Milwaukee,95,2021000,21273.684210526317,44,1661000,37750.0,51,360000
2019,county,48439,Tarrant,01097,Mobile,AL,Mobile,51,971000,19039.21568627451,41,986000,24048.780487804877,10,-15000
2019,county,48113,Dallas,01097,Mobile,AL,Mobile,75,1473000,19640.0,33,1016000,30787.878787878788,42,457000
2019,county,48113,Dallas,36055,Monroe,NY,Rochester,67,5615000,83805.97014925373,37,1419000,38351.35135135135,30,4196000
2019,county,48439,Tarrant,48337,Montague,TX,Rural Texas,86,2504000,29116.279069767443,157,4443000,28299.36305732484,-71,-1939000
2019,county,48121,Denton,48337,Montague,TX,Rural Texas,83,2309000,27819.277108433736,133,4209000,31646.61654135338,-50,-1900000
2019,county,48113,Dallas,06053,Monterey,CA,Rural California,41,2368000,57756.09756097561,41,1284000,31317.073170731706,0,1084000
2019,county,48439,Tarrant,48339,Montgomery,TX,Houston,356,19843000,55738.76404494382,494,29703000,60127.53036437247,-138,-9860000
2019,county,48439,Tarrant,24031,Montgomery,MD,D.C.,100,7718000,77180.0,92,7906000,85934.78260869565,8,-188000
2019,county,48439,Tarrant,39113,Montgomery,OH,Rural Ohio,77,2292000,29766.233766233767,46,1488000,32347.82608695652,31,804000
2019,county,48439,Tarrant,47125,Montgomery,TN,Rural Tennessee,80,1650000,20625.0,72,1271000,17652.777777777777,8,379000
2019,county,48113,Dallas,48339,Montgomery,TX,Houston,291,13578000,46659.79381443299,342,20447000,59786.54970760234,-51,-6869000
2019,county,48113,Dallas,24031,Montgomery,MD,D.C.,164,11520000,70243.90243902439,109,5543000,50853.21100917431,55,5977000
2019,county,48113,Dallas,42091,Montgomery,PA,Philadelphia,81,5116000,63160.49382716049,84,4023000,47892.857142857145,-3,1093000
2019,county,48113,Dallas,39113,Montgomery,OH,Rural Ohio,54,1062000,19666.666666666668,41,1555000,37926.829268292684,13,-493000
2019,county,48121,Denton,48339,Montgomery,TX,Houston,240,12718000,52991.666666666664,202,9006000,44584.158415841586,38,3712000
2019,county,48085,Collin,48339,Montgomery,TX,Houston,234,13334000,56982.905982905984,236,10641000,45088.983050847455,-2,2693000
2019,county,48085,Collin,24031,Montgomery,MD,D.C.,101,4144000,41029.70297029703,86,4215000,49011.62790697674,15,-71000
2019,county,48439,Tarrant,34027,Morris,NJ,New York,35,2589000,73971.42857142857,48,2767000,57645.833333333336,-13,-178000
2019,county,48113,Dallas,34027,Morris,NJ,New York,90,5172000,57466.666666666664,45,2931000,65133.333333333336,45,2241000
2019,county,48439,Tarrant,41051,Multnomah,OR,Portland,83,2272000,27373.493975903613,75,1955000,26066.666666666668,8,317000
2019,county,48113,Dallas,41051,Multnomah,OR,Portland,77,4932000,64051.94805194805,138,8923000,64659.42028985507,-61,-3991000
2019,county,48439,Tarrant,48347,Nacogdoches,TX,Rural Texas,116,1977000,17043.103448275862,56,1538000,27464.285714285714,60,439000
2019,county,48113,Dallas,48347,Nacogdoches,TX,Rural Texas,99,1838000,18565.656565656565,73,1191000,16315.068493150686,26,647000
2019,county,48439,Tarrant,36059,Nassau,NY,New York,49,2011000,41040.816326530614,47,1161000,24702.127659574468,2,850000
2019,county,48113,Dallas,36059,Nassau,NY,New York,140,4969000,35492.857142857145,64,3191000,49859.375,76,1778000
2019,county,48085,Collin,36059,Nassau,NY,New York,117,4478000,38273.50427350427,38,1096000,28842.105263157893,79,3382000
2019,county,48439,Tarrant,48349,Navarro,TX,Rural Texas,125,4254000,34032.0,162,6051000,37351.851851851854,-37,-1797000
2019,county,48113,Dallas,48349,Navarro,TX,Rural Texas,368,5921000,16089.673913043478,496,10216000,20596.774193548386,-128,-4295000
2019,county,48121,Denton,48349,Navarro,TX,Rural Texas,51,1012000,19843.13725490196,47,1410000,30000.0,4,-398000
2019,county,48113,Dallas,10003,New Castle,DE,Rural Delaware,82,3226000,39341.46341463415,58,1966000,33896.55172413793,24,1260000
2019,county,48439,Tarrant,09009,New Haven,CT,New Haven,53,1964000,37056.6037735849,33,1054000,31939.39393939394,20,910000
2019,county,48113,Dallas,09009,New Haven,CT,New Haven,72,3214000,44638.88888888889,54,2708000,50148.148148148146,18,506000
2019,county,48439,Tarrant,36061,New York,NY,New York,117,9318000,79641.02564102564,100,7314000,73140.0,17,2004000
2019,county,48113,Dallas,36061,New York,NY,New York,447,64686000,144711.40939597314,447,59271000,132597.31543624162,0,5415000
2019,county,48121,Denton,36061,New York,NY,New York,67,9645000,143955.223880597,56,3747000,66910.71428571429,11,5898000
2019,county,48085,Collin,36061,New York,NY,New York,114,5941000,52114.0350877193,103,10648000,103378.64077669903,11,-4707000
2019,county,48439,Tarrant,25021,Norfolk,MA,Boston,44,1454000,33045.454545454544,37,3834000,103621.62162162163,7,-2380000
2019,county,48113,Dallas,25021,Norfolk,MA,Boston,93,9439000,101494.62365591398,92,9047000,98336.95652173914,1,392000
2019,county,48085,Collin,25021,Norfolk,MA,Boston,84,4201000,50011.90476190476,51,3353000,65745.09803921569,33,848000
2019,county,48439,Tarrant,51710,Norfolk city,VA,Hampton Roads,66,1462000,22151.515151515152,30,653000,21766.666666666668,36,809000
2019,county,48113,Dallas,51710,Norfolk city,VA,Hampton Roads,36,1030000,28611.11111111111,35,843000,24085.714285714286,1,187000
2019,county,48439,Tarrant,48355,Nueces,TX,Rural Texas,284,7585000,26707.74647887324,212,6188000,29188.67924528302,72,1397000
2019,county,48113,Dallas,48355,Nueces,TX,Rural Texas,219,5776000,26374.429223744293,165,3773000,22866.666666666668,54,2003000
2019,county,48121,Denton,48355,Nueces,TX,Rural Texas,88,2411000,27397.727272727272,87,2931000,33689.65517241379,1,-520000
2019,county,48085,Collin,48355,Nueces,TX,Rural Texas,105,4324000,41180.95238095238,58,1873000,32293.103448275862,47,2451000
2019,county,48439,Tarrant,26125,Oakland,MI,Detroit,132,6757000,51189.393939393936,119,3827000,32159.66386554622,13,2930000
2019,county,48113,Dallas,26125,Oakland,MI,Detroit,203,9128000,44965.51724137931,118,6031000,51110.16949152543,85,3097000
2019,county,48121,Denton,26125,Oakland,MI,Detroit,108,4519000,41842.59259259259,45,2961000,65800.0,63,1558000
2019,county,48085,Collin,26125,Oakland,MI,Detroit,217,8054000,37115.20737327189,102,4430000,43431.37254901961,115,3624000
2019,county,48439,Tarrant,12091,Okaloosa,FL,FL Panhandle,85,2413000,28388.235294117647,40,1589000,39725.0,45,824000
2019,county,48113,Dallas,12091,Okaloosa,FL,FL Panhandle,37,1175000,31756.756756756757,43,1333000,31000.0,-6,-158000
2019,county,48439,Tarrant,40109,Oklahoma,OK,Oklahoma City,556,25148000,45230.21582733813,500,15377000,30754.0,56,9771000
2019,county,48113,Dallas,40109,Oklahoma,OK,Oklahoma City,493,24596000,49890.466531440165,431,15355000,35626.450116009284,62,9241000
2019,county,48121,Denton,40109,Oklahoma,OK,Oklahoma City,302,10305000,34122.51655629139,254,10249000,40350.393700787405,48,56000
2019,county,48085,Collin,40109,Oklahoma,OK,Oklahoma City,307,9514000,30990.228013029315,260,10550000,40576.92307692308,47,-1036000
2019,county,48439,Tarrant,37133,Onslow,NC,Rural North Carolina,117,2199000,18794.871794871793,51,974000,19098.039215686276,66,1225000
2019,county,48113,Dallas,37133,Onslow,NC,Rural North Carolina,89,1916000,21528.08988764045,47,1063000,22617.021276595744,42,853000
2019,county,48439,Tarrant,06059,Orange,CA,Los Angeles,610,25636000,42026.229508196724,331,12139000,36673.716012084595,279,13497000
2019,county,48439,Tarrant,12095,Orange,FL,Orlando,303,11118000,36693.069306930694,260,11860000,45615.38461538462,43,-742000
2019,county,48113,Dallas,06059,Orange,CA,Los Angeles,592,29251000,49410.47297297297,450,38714000,86031.11111111111,142,-9463000
2019,county,48113,Dallas,12095,Orange,FL,Orlando,307,11492000,37433.22475570033,237,10663000,44991.5611814346,70,829000
2019,county,48121,Denton,06059,Orange,CA,Los Angeles,622,30824000,49556.27009646302,180,12751000,70838.88888888889,442,18073000
2019,county,48121,Denton,12095,Orange,FL,Orlando,118,4764000,40372.8813559322,113,3427000,30327.433628318584,5,1337000
2019,county,48085,Collin,06059,Orange,CA,Los Angeles,760,40521000,53317.10526315789,382,24319000,63662.30366492146,378,16202000
2019,county,48085,Collin,12095,Orange,FL,Orlando,172,7638000,44406.976744186046,114,4942000,43350.87719298246,58,2696000
2019,county,48439,Tarrant,22071,Orleans Parish,LA,New Orleans,174,4198000,24126.436781609194,97,2350000,24226.80412371134,77,1848000
2019,county,48113,Dallas,22071,Orleans Parish,LA,New Orleans,230,6721000,29221.739130434784,154,5572000,36181.818181818184,76,1149000
2019,county,48121,Denton,22071,Orleans Parish,LA,New Orleans,65,955000,14692.307692307691,54,1745000,32314.814814814814,11,-790000
2019,county,48085,Collin,22071,Orleans Parish,LA,New Orleans,70,1416000,20228.571428571428,51,946000,18549.019607843136,19,470000
2019,county,48439,Tarrant,12097,Osceola,FL,Orlando,100,1672000,16720.0,63,1495000,23730.15873015873,37,177000
2019,county,48439,Tarrant,22073,Ouachita Parish,LA,Rural Louisiana,252,3115000,12361.111111111111,113,1149000,10168.141592920354,139,1966000
2019,county,48113,Dallas,22073,Ouachita Parish,LA,Rural Louisiana,314,4913000,15646.496815286624,120,1469000,12241.666666666666,194,3444000
2019,county,48439,Tarrant,12099,Palm Beach,FL,Miami,158,11177000,70740.50632911392,121,17111000,141413.22314049586,37,-5934000
2019,county,48113,Dallas,12099,Palm Beach,FL,Miami,222,40292000,181495.4954954955,184,50709000,275592.39130434784,38,-10417000
2019,county,48121,Denton,12099,Palm Beach,FL,Miami,122,5766000,47262.29508196721,101,9407000,93138.61386138614,21,-3641000
2019,county,48085,Collin,12099,Palm Beach,FL,Miami,156,5679000,36403.846153846156,84,5863000,69797.61904761905,72,-184000
2019,county,48439,Tarrant,48363,Palo Pinto,TX,Rural Texas,228,5787000,25381.57894736842,248,7409000,29875.0,-20,-1622000
2019,county,48439,Tarrant,48367,Parker,TX,Dallas-Fort Worth,3147,104081000,33073.08547823324,5733,228201000,39804.81423338566,-2586,-124120000
2019,county,48113,Dallas,48367,Parker,TX,Dallas-Fort Worth,196,11299000,57647.95918367347,289,10831000,37477.508650519034,-93,468000
2019,county,48121,Denton,48367,Parker,TX,Dallas-Fort Worth,237,10816000,45637.13080168777,321,13624000,42442.36760124611,-84,-2808000
2019,county,48085,Collin,48367,Parker,TX,Dallas-Fort Worth,67,2608000,38925.37313432836,134,6373000,47559.701492537315,-67,-3765000
2019,county,48439,Tarrant,12101,Pasco,FL,Tampa,44,1075000,24431.81818181818,51,2059000,40372.549019607846,-7,-984000
2019,county,48113,Dallas,12101,Pasco,FL,Tampa,52,1226000,23576.923076923078,74,2393000,32337.837837837837,-22,-1167000
2019,county,48121,Denton,12101,Pasco,FL,Tampa,55,1423000,25872.727272727272,47,1566000,33319.14893617021,8,-143000
2019,county,48439,Tarrant,42101,Philadelphia,PA,Philadelphia,86,4331000,50360.46511627907,59,1994000,33796.61016949153,27,2337000
2019,county,48113,Dallas,42101,Philadelphia,PA,Philadelphia,127,7541000,59377.95275590551,146,6937000,47513.69863013698,-19,604000
2019,county,48085,Collin,42101,Philadelphia,PA,Philadelphia,43,1389000,32302.325581395347,42,2354000,56047.619047619046,1,-965000
2019,county,48439,Tarrant,53053,Pierce,WA,Seattle,182,4779000,26258.24175824176,180,4485000,24916.666666666668,2,294000
2019,county,48113,Dallas,53053,Pierce,WA,Seattle,106,3101000,29254.716981132075,115,2371000,20617.391304347828,-9,730000
2019,county,48121,Denton,53053,Pierce,WA,Seattle,83,2634000,31734.939759036144,57,1457000,25561.40350877193,26,1177000
2019,county,48085,Collin,53053,Pierce,WA,Seattle,122,3876000,31770.491803278688,69,3147000,45608.69565217391,53,729000
2019,county,48439,Tarrant,04019,Pima,AZ,Tucson,208,8851000,42552.88461538462,150,9258000,61720.0,58,-407000
2019,county,48113,Dallas,04019,Pima,AZ,Tucson,155,8293000,53503.22580645161,125,6112000,48896.0,30,2181000
2019,county,48121,Denton,04019,Pima,AZ,Tucson,72,2943000,40875.0,59,2461000,41711.86440677966,13,482000
2019,county,48085,Collin,04019,Pima,AZ,Tucson,155,8784000,56670.967741935485,91,3563000,39153.846153846156,64,5221000
2019,county,48439,Tarrant,04021,Pinal,AZ,Phoenix,71,2036000,28676.056338028167,58,1999000,34465.51724137931,13,37000
2019,county,48439,Tarrant,12103,Pinellas,FL,Tampa,102,3722000,36490.19607843137,93,3950000,42473.11827956989,9,-228000
2019,county,48113,Dallas,12103,Pinellas,FL,Tampa,97,4622000,47649.48453608248,137,14214000,103751.82481751825,-40,-9592000
2019,county,48121,Denton,12103,Pinellas,FL,Tampa,56,2280000,40714.28571428572,61,2878000,47180.32786885246,-5,-598000
2019,county,48085,Collin,12103,Pinellas,FL,Tampa,86,3347000,38918.604651162794,77,6373000,82766.23376623377,9,-3026000
2019,county,48439,Tarrant,12105,Polk,FL,Orlando,90,2184000,24266.666666666668,98,1948000,19877.551020408162,-8,236000
2019,county,48439,Tarrant,48373,Polk,TX,Rural Texas,54,1221000,22611.11111111111,101,6090000,60297.0297029703,-47,-4869000
2019,county,48439,Tarrant,19153,Polk,IA,Rural Iowa,50,1089000,21780.0,43,1710000,39767.441860465115,7,-621000
2019,county,48113,Dallas,19153,Polk,IA,Rural Iowa,104,4050000,38942.307692307695,79,2934000,37139.240506329115,25,1116000
2019,county,48113,Dallas,12105,Polk,FL,Orlando,46,626000,13608.695652173914,96,2607000,27156.25,-50,-1981000
2019,county,48085,Collin,12105,Polk,FL,Orlando,53,1265000,23867.924528301886,47,1843000,39212.765957446805,6,-578000
2019,county,48439,Tarrant,48375,Potter,TX,Rural Texas,190,4389000,23100.0,68,1248000,18352.941176470587,122,3141000
2019,county,48113,Dallas,48375,Potter,TX,Rural Texas,97,1337000,13783.505154639175,67,2288000,34149.253731343284,30,-951000
2019,county,48121,Denton,48375,Potter,TX,Rural Texas,74,2200000,29729.72972972973,29,917000,31620.689655172413,45,1283000
2019,county,48439,Tarrant,24033,Prince George,MD,Rural Maryland,106,2642000,24924.528301886792,64,1597000,24953.125,42,1045000
2019,county,48113,Dallas,24033,Prince George,MD,Rural Maryland,154,4651000,30201.2987012987,63,1952000,30984.126984126986,91,2699000
2019,county,48085,Collin,24033,Prince George,MD,Rural Maryland,74,2114000,28567.567567567567,44,1255000,28522.727272727272,30,859000
2019,county,48439,Tarrant,51153,Prince William,VA,Rural Virginia,97,2963000,30546.39175257732,71,2369000,33366.19718309859,26,594000
2019,county,48113,Dallas,51153,Prince William,VA,Rural Virginia,71,2615000,36830.98591549296,50,2071000,41420.0,21,544000
2019,county,48439,Tarrant,44007,Providence,RI,Providence,60,1879000,31316.666666666668,31,1402000,45225.8064516129,29,477000
2019,county,48113,Dallas,44007,Providence,RI,Providence,40,1669000,41725.0,39,1381000,35410.256410256414,1,288000
2019,county,48439,Tarrant,05119,Pulaski,AR,Little Rock,219,13342000,60922.374429223746,200,3878000,19390.0,19,9464000
2019,county,48113,Dallas,05119,Pulaski,AR,Little Rock,400,12491000,31227.5,241,7002000,29053.941908713692,159,5489000
2019,county,48121,Denton,05119,Pulaski,AR,Little Rock,147,4183000,28455.78231292517,64,1886000,29468.75,83,2297000
2019,county,48085,Collin,05119,Pulaski,AR,Little Rock,176,5498000,31238.636363636364,75,2715000,36200.0,101,2783000
2019,county,48439,Tarrant,36081,Queens,NY,New York,232,6185000,26659.48275862069,45,1674000,37200.0,187,4511000
2019,county,48113,Dallas,36081,Queens,NY,New York,315,12125000,38492.06349206349,122,4939000,40483.60655737705,193,7186000
2019,county,48121,Denton,36081,Queens,NY,New York,119,4611000,38747.899159663866,32,1513000,47281.25,87,3098000
2019,county,48085,Collin,36081,Queens,NY,New York,215,8596000,39981.395348837206,43,1070000,24883.720930232557,172,7526000
2019,county,48439,Tarrant,27123,Ramsey,MN,Minneapolis,51,2133000,41823.529411764706,42,622000,14809.52380952381,9,1511000
2019,county,48113,Dallas,27123,Ramsey,MN,Minneapolis,109,2888000,26495.4128440367,69,2150000,31159.420289855072,40,738000
2019,county,48439,Tarrant,48381,Randall,TX,Rural Texas,211,6743000,31957.34597156398,146,4774000,32698.630136986303,65,1969000
2019,county,48113,Dallas,48381,Randall,TX,Rural Texas,128,6306000,49265.625,96,3459000,36031.25,32,2847000
2019,county,48121,Denton,48381,Randall,TX,Rural Texas,87,2653000,30494.25287356322,63,2980000,47301.5873015873,24,-327000
2019,county,48085,Collin,48381,Randall,TX,Rural Texas,89,2594000,29146.067415730337,37,1503000,40621.62162162162,52,1091000
2019,county,48113,Dallas,22079,Rapides Parish,LA,Rural Louisiana,60,1582000,26366.666666666668,38,428000,11263.157894736842,22,1154000
2019,county,48439,Tarrant,45079,Richland,SC,Columbia,38,1045000,27500.0,35,1292000,36914.28571428572,3,-247000
2019,county,48113,Dallas,45079,Richland,SC,Columbia,53,2147000,40509.43396226415,45,1627000,36155.555555555555,8,520000
2019,county,48113,Dallas,51760,Richmond city,VA,Richmond,38,8909000,234447.36842105264,41,2162000,52731.70731707317,-3,6747000
2019,county,48439,Tarrant,06065,Riverside,CA,San Bernardino-Riverside,467,16387000,35089.935760171305,174,4426000,25436.7816091954,293,11961000
2019,county,48113,Dallas,06065,Riverside,CA,San Bernardino-Riverside,251,8069000,32147.410358565736,153,5288000,34562.09150326798,98,2781000
2019,county,48121,Denton,06065,Riverside,CA,San Bernardino-Riverside,249,11153000,44791.16465863454,82,2992000,36487.80487804878,167,8161000
2019,county,48085,Collin,06065,Riverside,CA,San Bernardino-Riverside,277,9030000,32599.27797833935,116,4847000,41784.48275862069,161,4183000
2019,county,48439,Tarrant,48397,Rockwall,TX,Dallas-Fort Worth,200,7147000,35735.0,271,8477000,31280.442804428043,-71,-1330000
2019,county,48113,Dallas,48397,Rockwall,TX,Dallas-Fort Worth,1879,77437000,41211.814795103775,3808,143395000,37656.25,-1929,-65958000
2019,county,48121,Denton,48397,Rockwall,TX,Dallas-Fort Worth,208,7602000,36548.07692307692,275,10147000,36898.181818181816,-67,-2545000
2019,county,48085,Collin,48397,Rockwall,TX,Dallas-Fort Worth,1020,36781000,36059.80392156863,1263,43470000,34418.052256532064,-243,-6689000
2019,county,48113,Dallas,48401,Rusk,TX,Rural Texas,72,1334000,18527.777777777777,69,1521000,22043.478260869564,3,-187000
2019,county,48439,Tarrant,47149,Rutherford,TN,Nashville,58,2067000,35637.93103448276,40,1059000,26475.0,18,1008000
2019,county,48439,Tarrant,06067,Sacramento,CA,Sacramento,242,7245000,29938.01652892562,97,2399000,24731.9587628866,145,4846000
2019,county,48113,Dallas,06067,Sacramento,CA,Sacramento,218,10406000,47733.94495412844,171,6643000,38847.95321637427,47,3763000
2019,county,48121,Denton,06067,Sacramento,CA,Sacramento,80,2720000,34000.0,41,1542000,37609.756097560974,39,1178000
2019,county,48085,Collin,06067,Sacramento,CA,Sacramento,160,7218000,45112.5,65,2347000,36107.692307692305,95,4871000
2019,county,48439,Tarrant,05125,Saline,AR,Little Rock,51,926000,18156.86274509804,52,2261000,43480.769230769234,-1,-1335000
2019,county,48113,Dallas,05125,Saline,AR,Little Rock,45,1873000,41622.22222222222,55,2011000,36563.63636363636,-10,-138000
2019,county,48439,Tarrant,49035,Salt Lake,UT,Salt Lake,137,3754000,27401.4598540146,160,5508000,34425.0,-23,-1754000
2019,county,48113,Dallas,49035,Salt Lake,UT,Salt Lake,208,9615000,46225.96153846154,146,6286000,43054.79452054795,62,3329000
2019,county,48121,Denton,49035,Salt Lake,UT,Salt Lake,121,3935000,32520.661157024795,100,4803000,48030.0,21,-868000
2019,county,48085,Collin,49035,Salt Lake,UT,Salt Lake,193,7424000,38466.321243523314,86,4071000,47337.20930232558,107,3353000
2019,county,48439,Tarrant,06071,San Bernardino,CA,San Bernardino-Riverside,423,9633000,22773.04964539007,166,6614000,39843.3734939759,257,3019000
2019,county,48113,Dallas,06071,San Bernardino,CA,San Bernardino-Riverside,241,6101000,25315.352697095437,192,4568000,23791.666666666668,49,1533000
2019,county,48121,Denton,06071,San Bernardino,CA,San Bernardino-Riverside,186,5834000,31365.59139784946,46,1164000,25304.347826086956,140,4670000
2019,county,48085,Collin,06071,San Bernardino,CA,San Bernardino-Riverside,244,6394000,26204.918032786885,108,2618000,24240.74074074074,136,3776000
2019,county,48439,Tarrant,06073,San Diego,CA,San Diego,831,33277000,40044.524669073406,493,14681000,29778.904665314403,338,18596000
2019,county,48113,Dallas,06073,San Diego,CA,San Diego,757,34424000,45474.24042272127,493,25526000,51776.87626774848,264,8898000
2019,county,48121,Denton,06073,San Diego,CA,San Diego,456,24079000,52804.82456140351,142,4982000,35084.50704225352,314,19097000
2019,county,48085,Collin,06073,San Diego,CA,San Diego,541,21006000,38828.09611829944,254,12188000,47984.25196850394,287,8818000
2019,county,48439,Tarrant,06075,San Francisco,CA,Bay Area,65,4221000,64938.46153846154,40,2504000,62600.0,25,1717000
2019,county,48113,Dallas,06075,San Francisco,CA,Bay Area,191,23045000,120654.4502617801,239,22098000,92460.2510460251,-48,947000
2019,county,48085,Collin,06075,San Francisco,CA,Bay Area,68,5871000,86338.23529411765,67,9269000,138343.28358208956,1,-3398000
2019,county,48439,Tarrant,06077,San Joaquin,CA,Bay Area,72,1440000,20000.0,52,970000,18653.846153846152,20,470000
2019,county,48113,Dallas,06077,San Joaquin,CA,Bay Area,45,822000,18266.666666666668,37,784000,21189.18918918919,8,38000
2019,county,48439,Tarrant,06081,San Mateo,CA,Bay Area,83,4856000,58506.02409638554,39,4556000,116820.51282051283,44,300000
2019,county,48113,Dallas,06081,San Mateo,CA,Bay Area,123,10890000,88536.58536585367,104,9400000,90384.61538461539,19,1490000
2019,county,48085,Collin,06081,San Mateo,CA,Bay Area,80,6956000,86950.0,61,5143000,84311.47540983607,19,1813000
2019,county,48439,Tarrant,06083,Santa Barbara,CA,Rural California,63,2426000,38507.93650793651,41,1379000,33634.14634146341,22,1047000
2019,county,48113,Dallas,06083,Santa Barbara,CA,Rural California,50,2865000,57300.0,40,1872000,46800.0,10,993000
2019,county,48439,Tarrant,06085,Santa Clara,CA,Bay Area,232,12347000,53219.8275862069,177,8137000,45971.75141242938,55,4210000
2019,county,48113,Dallas,06085,Santa Clara,CA,Bay Area,344,29278000,85110.46511627907,366,25828000,70568.30601092897,-22,3450000
2019,county,48121,Denton,06085,Santa Clara,CA,Bay Area,211,17598000,83402.84360189573,85,7401000,87070.58823529411,126,10197000
2019,county,48085,Collin,06085,Santa Clara,CA,Bay Area,617,37919000,61457.05024311183,409,29241000,71493.88753056235,208,8678000
2019,county,48113,Dallas,35049,Santa Fe,NM,Rural New Mexico,35,2479000,70828.57142857143,70,21887000,312671.4285714286,-35,-19408000
2019,county,48439,Tarrant,12113,Santa Rosa,FL,FL Panhandle,56,1756000,31357.14285714286,40,1791000,44775.0,16,-35000
2019,county,48439,Tarrant,12115,Sarasota,FL,S.W. Florida,32,2665000,83281.25,51,3158000,61921.56862745098,-19,-493000
2019,county,48113,Dallas,12115,Sarasota,FL,S.W. Florida,43,1744000,40558.13953488372,36,2158000,59944.444444444445,7,-414000
2019,county,48439,Tarrant,05131,Sebastian,AR,Rural Arkansas,49,1970000,40204.08163265306,68,2154000,31676.470588235294,-19,-184000
2019,county,48439,Tarrant,20173,Sedgwick,KS,Rural Kansas,243,7561000,31115.22633744856,162,4557000,28129.62962962963,81,3004000
2019,county,48113,Dallas,20173,Sedgwick,KS,Rural Kansas,200,5781000,28905.0,114,2596000,22771.929824561405,86,3185000
2019,county,48121,Denton,20173,Sedgwick,KS,Rural Kansas,92,3851000,41858.69565217391,69,1665000,24130.434782608696,23,2186000
2019,county,48085,Collin,20173,Sedgwick,KS,Rural Kansas,109,6125000,56192.66055045871,49,1700000,34693.87755102041,60,4425000
2019,county,48439,Tarrant,12117,Seminole,FL,Orlando,40,1301000,32525.0,57,1889000,33140.350877192985,-17,-588000
2019,county,48113,Dallas,12117,Seminole,FL,Orlando,81,4185000,51666.666666666664,87,3242000,37264.36781609195,-6,943000
2019,county,48085,Collin,12117,Seminole,FL,Orlando,85,3511000,41305.882352941175,46,1634000,35521.739130434784,39,1877000
2019,county,48439,Tarrant,47157,Shelby,TN,Memphis,335,8753000,26128.358208955226,173,4241000,24514.450867052023,162,4512000
2019,county,48113,Dallas,47157,Shelby,TN,Memphis,420,9901000,23573.809523809523,257,7100000,27626.45914396887,163,2801000
2019,county,48121,Denton,47157,Shelby,TN,Memphis,225,8181000,36360.0,88,3358000,38159.09090909091,137,4823000
2019,county,48085,Collin,47157,Shelby,TN,Memphis,180,5692000,31622.222222222223,95,4404000,46357.89473684211,85,1288000
2019,county,48439,Tarrant,48423,Smith,TX,Rural Texas,458,13317000,29076.4192139738,392,15742000,40158.163265306124,66,-2425000
2019,county,48113,Dallas,48423,Smith,TX,Rural Texas,706,19972000,28288.951841359773,720,29473000,40934.72222222222,-14,-9501000
2019,county,48121,Denton,48423,Smith,TX,Rural Texas,223,7896000,35408.07174887892,173,6428000,37156.06936416185,50,1468000
2019,county,48085,Collin,48423,Smith,TX,Rural Texas,289,10778000,37294.117647058825,239,9777000,40907.94979079498,50,1001000
2019,county,48439,Tarrant,53061,Snohomish,WA,Seattle,140,4619000,32992.857142857145,66,2235000,33863.63636363636,74,2384000
2019,county,48113,Dallas,53061,Snohomish,WA,Seattle,94,5011000,53308.51063829787,73,2949000,40397.260273972606,21,2062000
2019,county,48121,Denton,53061,Snohomish,WA,Seattle,56,3104000,55428.57142857143,46,1838000,39956.52173913043,10,1266000
2019,county,48085,Collin,53061,Snohomish,WA,Seattle,145,8404000,57958.620689655174,75,2203000,29373.333333333332,70,6201000
2019,county,48439,Tarrant,06095,Solano,CA,Bay Area,88,2294000,26068.18181818182,39,1291000,33102.5641025641,49,1003000
2019,county,48113,Dallas,06095,Solano,CA,Bay Area,41,2136000,52097.560975609755,31,903000,29129.032258064515,10,1233000
2019,county,48113,Dallas,34035,Somerset,NJ,New York,80,3742000,46775.0,36,2123000,58972.22222222222,44,1619000
2019,county,48085,Collin,34035,Somerset,NJ,New York,91,4780000,52527.47252747253,49,3383000,69040.8163265306,42,1397000
2019,county,48439,Tarrant,53063,Spokane,WA,Spokane,42,1307000,31119.04761904762,42,1551000,36928.57142857143,0,-244000
2019,county,48439,Tarrant,29183,St. Charles,MO,St. Louis,76,2893000,38065.78947368421,68,2256000,33176.470588235294,8,637000
2019,county,48113,Dallas,29183,St. Charles,MO,St. Louis,73,2817000,38589.04109589041,46,1441000,31326.08695652174,27,1376000
2019,county,48121,Denton,29183,St. Charles,MO,St. Louis,52,2312000,44461.53846153846,56,2165000,38660.71428571428,-4,147000
2019,county,48439,Tarrant,29189,St. Louis,MO,St. Louis,230,7283000,31665.217391304348,128,4215000,32929.6875,102,3068000
2019,county,48113,Dallas,29189,St. Louis,MO,St. Louis,336,11922000,35482.142857142855,193,8711000,45134.715025906735,143,3211000
2019,county,48121,Denton,29189,St. Louis,MO,St. Louis,123,6059000,49260.16260162602,46,1783000,38760.86956521739,77,4276000
2019,county,48085,Collin,29189,St. Louis,MO,St. Louis,230,10143000,44100.0,116,5868000,50586.206896551725,114,4275000
2019,county,48439,Tarrant,29510,St. Louis city,MO,Rural Missouri,78,1739000,22294.871794871793,58,1539000,26534.48275862069,20,200000
2019,county,48113,Dallas,29510,St. Louis city,MO,Rural Missouri,140,4995000,35678.57142857143,66,3869000,58621.21212121212,74,1126000
2019,county,48439,Tarrant,12111,St. Lucie,FL,Atlantic Coast,85,2671000,31423.529411764706,52,1663000,31980.76923076923,33,1008000
2019,county,48439,Tarrant,22103,St. Tammany Parish,LA,New Orleans,86,2852000,33162.79069767442,39,1594000,40871.794871794875,47,1258000
2019,county,48113,Dallas,22103,St. Tammany Parish,LA,New Orleans,78,3530000,45256.41025641026,43,1850000,43023.25581395349,35,1680000
2019,county,48439,Tarrant,25025,Suffolk,MA,Boston,43,3086000,71767.44186046511,40,3194000,79850.0,3,-108000
2019,county,48113,Dallas,25025,Suffolk,MA,Boston,145,10319000,71165.5172413793,153,14813000,96816.99346405228,-8,-4494000
2019,county,48113,Dallas,36103,Suffolk,NY,New York,146,12024000,82356.16438356164,61,2616000,42885.24590163935,85,9408000
2019,county,48085,Collin,25025,Suffolk,MA,Boston,46,2062000,44826.086956521736,24,1468000,61166.666666666664,22,594000
2019,county,48439,Tarrant,39153,Summit,OH,Rural Ohio,35,1268000,36228.57142857143,40,1228000,30700.0,-5,40000
2019,county,48113,Dallas,39153,Summit,OH,Rural Ohio,35,1536000,43885.71428571428,30,1098000,36600.0,5,438000
2019,county,48113,Dallas,48439,Tarrant,TX,Dallas-Fort Worth,19618,693606000,35355.591803445815,24134,697533000,28902.502693295766,-4516,-3927000
2019,county,48121,Denton,48439,Tarrant,TX,Dallas-Fort Worth,10177,405460000,39840.817529723885,7043,394324000,55988.07326423399,3134,11136000
2019,county,48085,Collin,48439,Tarrant,TX,Dallas-Fort Worth,3557,124988000,35138.59994377284,2508,105619000,42112.83891547049,1049,19369000
2019,county,48439,Tarrant,48441,Taylor,TX,Rural Texas,412,9683000,23502.427184466018,346,11105000,32095.37572254335,66,-1422000
2019,county,48113,Dallas,48441,Taylor,TX,Rural Texas,241,6049000,25099.585062240665,176,3514000,19965.909090909092,65,2535000
2019,county,48121,Denton,48441,Taylor,TX,Rural Texas,100,2574000,25740.0,85,2622000,30847.058823529413,15,-48000
2019,county,48085,Collin,48441,Taylor,TX,Rural Texas,132,4670000,35378.78787878788,67,1606000,23970.149253731342,65,3064000
2019,county,48439,Tarrant,53067,Thurston,WA,Rural Washington,55,1058000,19236.363636363636,51,1124000,22039.21568627451,4,-66000
2019,county,48113,Dallas,48449,Titus,TX,Rural Texas,77,1212000,15740.25974025974,81,1278000,15777.777777777777,-4,-66000
2019,county,48439,Tarrant,48451,Tom Green,TX,Rural Texas,191,4554000,23842.931937172776,150,3987000,26580.0,41,567000
2019,county,48113,Dallas,48451,Tom Green,TX,Rural Texas,90,2302000,25577.777777777777,130,2544000,19569.23076923077,-40,-242000
2019,county,48121,Denton,48451,Tom Green,TX,Rural Texas,68,1030000,15147.058823529413,34,1658000,48764.705882352944,34,-628000
2019,county,48085,Collin,48451,Tom Green,TX,Rural Texas,40,1136000,28400.0,37,1084000,29297.297297297297,3,52000
2019,county,48439,Tarrant,48453,Travis,TX,Austin,900,40125000,44583.333333333336,1172,64659000,55169.795221843,-272,-24534000
2019,county,48113,Dallas,48453,Travis,TX,Austin,1722,96944000,56297.32868757259,2082,141981000,68194.52449567724,-360,-45037000
2019,county,48121,Denton,48453,Travis,TX,Austin,565,24244000,42909.734513274336,673,34100000,50668.647845468055,-108,-9856000
2019,county,48085,Collin,48453,Travis,TX,Austin,764,35429000,46373.03664921466,819,47658000,58190.47619047619,-55,-12229000
2019,county,48439,Tarrant,40143,Tulsa,OK,Tulsa,372,12894000,34661.290322580644,425,10904000,25656.470588235294,-53,1990000
2019,county,48113,Dallas,40143,Tulsa,OK,Tulsa,369,15835000,42913.27913279133,374,13426000,35898.39572192513,-5,2409000
2019,county,48121,Denton,40143,Tulsa,OK,Tulsa,195,7255000,37205.1282051282,141,5322000,37744.68085106383,54,1933000
2019,county,48085,Collin,40143,Tulsa,OK,Tulsa,285,9645000,33842.10526315789,131,5370000,40992.36641221374,154,4275000
2019,county,48113,Dallas,34039,Union,NJ,New York,40,1180000,29500.0,31,1794000,57870.967741935485,9,-614000
2019,county,48113,Dallas,48459,Upshur,TX,Rural Texas,39,497000,12743.589743589744,63,1544000,24507.93650793651,-24,-1047000
2019,county,48439,Tarrant,49049,Utah,UT,Rural Utah,111,2213000,19936.936936936938,106,4172000,39358.49056603773,5,-1959000
2019,county,48113,Dallas,49049,Utah,UT,Rural Utah,113,3122000,27628.318584070796,69,2213000,32072.463768115944,44,909000
2019,county,48121,Denton,49049,Utah,UT,Rural Utah,127,3219000,25346.456692913387,52,1993000,38326.92307692308,75,1226000
2019,county,48085,Collin,49049,Utah,UT,Rural Utah,150,4297000,28646.666666666668,173,5668000,32763.005780346823,-23,-1371000
2019,county,48439,Tarrant,48465,Val Verde,TX,Rural Texas,46,1886000,41000.0,61,1396000,22885.245901639344,-15,490000
2019,county,48439,Tarrant,48467,Van Zandt,TX,Rural Texas,92,2013000,21880.434782608696,106,4455000,42028.301886792455,-14,-2442000
2019,county,48113,Dallas,48467,Van Zandt,TX,Rural Texas,269,6180000,22973.977695167287,529,14011000,26485.822306238184,-260,-7831000
2019,county,48121,Denton,48467,Van Zandt,TX,Rural Texas,52,1092000,21000.0,97,4070000,41958.762886597935,-45,-2978000
2019,county,48085,Collin,48467,Van Zandt,TX,Rural Texas,94,2999000,31904.255319148935,91,3592000,39472.52747252747,3,-593000
2019,county,48439,Tarrant,06111,Ventura,CA,Los Angeles,145,12100000,83448.27586206897,74,2895000,39121.62162162162,71,9205000
2019,county,48113,Dallas,06111,Ventura,CA,Los Angeles,98,5360000,54693.87755102041,75,3071000,40946.666666666664,23,2289000
2019,county,48439,Tarrant,51810,Virginia Beach city,VA,Hampton Roads,138,3029000,21949.27536231884,65,1836000,28246.153846153848,73,1193000
2019,county,48113,Dallas,51810,Virginia Beach city,VA,Hampton Roads,68,1942000,28558.823529411766,65,2563000,39430.769230769234,3,-621000
2019,county,48439,Tarrant,12127,Volusia,FL,Atlantic Coast,68,1568000,23058.823529411766,32,2051000,64093.75,36,-483000
2019,county,48113,Dallas,12127,Volusia,FL,Atlantic Coast,55,902000,16400.0,30,1637000,54566.666666666664,25,-735000
2019,county,48439,Tarrant,37183,Wake,NC,Raleigh,84,2910000,34642.857142857145,154,5137000,33357.142857142855,-70,-2227000
2019,county,48113,Dallas,37183,Wake,NC,Raleigh,166,7190000,43313.25301204819,219,11414000,52118.72146118721,-53,-4224000
2019,county,48121,Denton,37183,Wake,NC,Raleigh,92,3769000,40967.391304347824,96,5034000,52437.5,-4,-1265000
2019,county,48085,Collin,37183,Wake,NC,Raleigh,165,7438000,45078.78787878788,119,5726000,48117.64705882353,46,1712000
2019,county,48439,Tarrant,48471,Walker,TX,Rural Texas,55,1220000,22181.81818181818,43,630000,14651.162790697674,12,590000
2019,county,48113,Dallas,48471,Walker,TX,Rural Texas,71,1451000,20436.61971830986,52,1228000,23615.384615384617,19,223000
2019,county,48439,Tarrant,05143,Washington,AR,Rural Arkansas,84,3019000,35940.47619047619,77,2601000,33779.22077922078,7,418000
2019,county,48439,Tarrant,41067,Washington,OR,Portland,63,2090000,33174.60317460317,73,2560000,35068.49315068493,-10,-470000
2019,county,48113,Dallas,05143,Washington,AR,Rural Arkansas,125,4413000,35304.0,99,3363000,33969.69696969697,26,1050000
2019,county,48113,Dallas,41067,Washington,OR,Portland,91,5100000,56043.956043956045,89,3614000,40606.74157303371,2,1486000
2019,county,48121,Denton,05143,Washington,AR,Rural Arkansas,50,2319000,46380.0,59,2200000,37288.13559322034,-9,119000
2019,county,48085,Collin,41067,Washington,OR,Portland,134,5245000,39141.79104477612,69,4106000,59507.24637681159,65,1139000
2019,county,48085,Collin,05143,Washington,AR,Rural Arkansas,66,2139000,32409.090909090908,55,2120000,38545.454545454544,11,19000
2019,county,48439,Tarrant,32031,Washoe,NV,Rural Nevada,87,2711000,31160.919540229886,75,3423000,45640.0,12,-712000
2019,county,48113,Dallas,32031,Washoe,NV,Rural Nevada,55,2554000,46436.36363636364,54,3619000,67018.51851851853,1,-1065000
2019,county,48085,Collin,32031,Washoe,NV,Rural Nevada,55,2077000,37763.63636363636,40,2054000,51350.0,15,23000
2019,county,48113,Dallas,26161,Washtenaw,MI,Rural Michigan,70,3680000,52571.42857142857,30,3160000,105333.33333333333,40,520000
2019,county,48085,Collin,26161,Washtenaw,MI,Rural Michigan,48,2739000,57062.5,37,2087000,56405.40540540541,11,652000
2019,county,48439,Tarrant,26163,Wayne,MI,Detroit,203,5266000,25940.886699507388,122,2667000,21860.655737704918,81,2599000
2019,county,48113,Dallas,26163,Wayne,MI,Detroit,212,6355000,29976.415094339623,121,4463000,36884.29752066116,91,1892000
2019,county,48121,Denton,26163,Wayne,MI,Detroit,111,5861000,52801.801801801805,35,1533000,43800.0,76,4328000
2019,county,48085,Collin,26163,Wayne,MI,Detroit,135,4448000,32948.148148148146,74,2396000,32378.37837837838,61,2052000
2019,county,48439,Tarrant,48479,Webb,TX,Rural Texas,112,1818000,16232.142857142857,77,1079000,14012.987012987012,35,739000
2019,county,48113,Dallas,48479,Webb,TX,Rural Texas,170,3564000,20964.70588235294,163,2652000,16269.938650306749,7,912000
2019,county,48439,Tarrant,08123,Weld,CO,Rural Colorado,49,1258000,25673.469387755104,64,2554000,39906.25,-15,-1296000
2019,county,48113,Dallas,36119,Westchester,NY,New York,83,4304000,51855.42168674699,47,12010000,255531.914893617,36,-7706000
2019,county,48439,Tarrant,48485,Wichita,TX,Rural Texas,355,8906000,25087.323943661973,321,7604000,23688.473520249223,34,1302000
2019,county,48113,Dallas,48485,Wichita,TX,Rural Texas,246,7568000,30764.227642276423,180,4131000,22950.0,66,3437000
2019,county,48121,Denton,48485,Wichita,TX,Rural Texas,175,4438000,25360.0,158,3973000,25145.569620253165,17,465000
2019,county,48085,Collin,48485,Wichita,TX,Rural Texas,109,3233000,29660.550458715596,82,1940000,23658.536585365855,27,1293000
2019,county,48439,Tarrant,17197,Will,IL,Chicago,144,6454000,44819.444444444445,50,1294000,25880.0,94,5160000
2019,county,48113,Dallas,17197,Will,IL,Chicago,141,4756000,33730.49645390071,54,1937000,35870.37037037037,87,2819000
2019,county,48439,Tarrant,48491,Williamson,TX,Austin,488,18790000,38504.098360655735,574,21937000,38217.770034843204,-86,-3147000
2019,county,48113,Dallas,48491,Williamson,TX,Austin,541,24048000,44451.016635859516,593,25192000,42482.2934232715,-52,-1144000
2019,county,48113,Dallas,47187,Williamson,TN,Nashville,46,3425000,74456.52173913043,66,6426000,97363.63636363637,-20,-3001000
2019,county,48121,Denton,48491,Williamson,TX,Austin,369,16677000,45195.12195121951,342,15122000,44216.37426900585,27,1555000
2019,county,48121,Denton,47187,Williamson,TN,Nashville,53,4009000,75641.50943396226,66,5517000,83590.90909090909,-13,-1508000
2019,county,48085,Collin,48491,Williamson,TX,Austin,502,20145000,40129.482071713144,447,18881000,42239.37360178971,55,1264000
2019,county,48439,Tarrant,48497,Wise,TX,Dallas-Fort Worth,1057,25838000,24444.65468306528,1802,55787000,30958.379578246393,-745,-29949000
2019,county,48113,Dallas,48497,Wise,TX,Dallas-Fort Worth,104,3165000,30432.69230769231,171,4456000,26058.479532163743,-67,-1291000
2019,county,48121,Denton,48497,Wise,TX,Dallas-Fort Worth,594,16617000,27974.747474747473,907,26670000,29404.63065049614,-313,-10053000
2019,county,48085,Collin,48497,Wise,TX,Dallas-Fort Worth,40,3534000,88350.0,63,2575000,40873.01587301587,-23,959000
2019,county,48439,Tarrant,48499,Wood,TX,Rural Texas,68,1456000,21411.764705882353,137,4371000,31905.109489051094,-69,-2915000
2019,county,48113,Dallas,48499,Wood,TX,Rural Texas,84,2191000,26083.333333333332,202,7682000,38029.70297029703,-118,-5491000
2019,county,48085,Collin,48499,Wood,TX,Rural Texas,55,1788000,32509.090909090908,92,4115000,44728.260869565216,-37,-2327000
2019,county,48439,Tarrant,25027,Worcester,MA,Rural Massachusetts,42,3261000,77642.85714285714,45,1387000,30822.222222222223,-3,1874000
2019,county,48113,Dallas,25027,Worcester,MA,Rural Massachusetts,68,4807000,70691.17647058824,59,2426000,41118.64406779661,9,2381000
2019,county,48085,Collin,25027,Worcester,MA,Rural Massachusetts,53,2245000,42358.49056603773,53,2565000,48396.22641509434,0,-320000
2019,county,48113,Dallas,45091,York,SC,Charlotte,51,2235000,43823.529411764706,40,2127000,53175.0,11,108000
2019,county,48439,Tarrant,48503,Young,TX,Rural Texas,63,1254000,19904.761904761905,78,2166000,27769.23076923077,-15,-912000
2019,total,48439,Tarrant,96000,,,,102195,3517924000,34423.64107833064,99038,3535613000,35699.55976493871,3157,-17689000
2019,total,48113,Dallas,96000,,,,115066,5062462000,43996.15872629621,138231,5473489000,39596.68236502666,-23165,-411027000
2019,total,48121,Denton,96000,,,,78429,3257159000,41530.03353351439,54239,2355294000,43424.36254355722,24190,901865000
2019,total,48085,Collin,96000,,,,81490,3388369000,41580.181617376365,66570,3040292000,45670.60237344149,14920,348077000
2020,county,48439,Tarrant,16001,Ada,ID,Rural Idaho,70,1745000,24928.571428571428,56,2767000,49410.71428571428,14,-1022000
2020,county,48113,Dallas,16001,Ada,ID,Rural Idaho,44,1699000,38613.63636363636,84,3889000,46297.619047619046,-40,-2190000
2020,county,48085,Collin,16001,Ada,ID,Rural Idaho,67,4471000,66731.34328358209,110,4518000,41072.72727272727,-43,-47000
2020,county,48439,Tarrant,08001,Adams,CO,Denver,98,3896000,39755.102040816324,101,3578000,35425.74257425743,-3,318000
2020,county,48113,Dallas,08001,Adams,CO,Denver,113,2757000,24398.230088495577,101,2984000,29544.554455445545,12,-227000
2020,county,48121,Denton,08001,Adams,CO,Denver,61,3035000,49754.098360655735,31,1341000,43258.06451612903,30,1694000
2020,county,48113,Dallas,12001,Alachua,FL,Rural Florida,72,3597000,49958.333333333336,38,1529000,40236.84210526316,34,2068000
2020,county,48439,Tarrant,06001,Alameda,CA,Bay Area,238,14474000,60815.12605042017,108,4415000,40879.62962962963,130,10059000
2020,county,48113,Dallas,06001,Alameda,CA,Bay Area,422,23629000,55992.89099526066,225,11962000,53164.444444444445,197,11667000
2020,county,48121,Denton,06001,Alameda,CA,Bay Area,166,8274000,49843.3734939759,77,3704000,48103.896103896106,89,4570000
2020,county,48085,Collin,06001,Alameda,CA,Bay Area,469,34380000,73304.9040511727,135,7607000,56348.148148148146,334,26773000
2020,county,48113,Dallas,51510,Alexandria city,VA,D.C.,64,3838000,59968.75,48,6227000,129729.16666666667,16,-2389000
2020,county,48439,Tarrant,42003,Allegheny,PA,Pittsburgh,94,4848000,51574.46808510638,126,4038000,32047.619047619046,-32,810000
2020,county,48113,Dallas,42003,Allegheny,PA,Pittsburgh,145,7663000,52848.275862068964,112,6364000,56821.42857142857,33,1299000
2020,county,48085,Collin,42003,Allegheny,PA,Pittsburgh,139,8394000,60388.489208633095,91,4454000,48945.054945054944,48,3940000
2020,county,48439,Tarrant,18003,Allen,IN,Rural Indiana,55,1519000,27618.18181818182,61,2576000,42229.50819672131,-6,-1057000
2020,county,48113,Dallas,18003,Allen,IN,Rural Indiana,29,1537000,53000.0,43,977000,22720.93023255814,-14,560000
2020,county,48439,Tarrant,02020,Anchorage Borough,AK,Rural Alaska,56,1638000,29250.0,53,1672000,31547.169811320753,3,-34000
2020,county,48439,Tarrant,48001,Anderson,TX,Rural Texas,102,2182000,21392.156862745098,122,2877000,23581.967213114753,-20,-695000
2020,county,48113,Dallas,48001,Anderson,TX,Rural Texas,84,1338000,15928.57142857143,121,3435000,28388.429752066117,-37,-2097000
2020,county,48439,Tarrant,48005,Angelina,TX,Rural Texas,65,1658000,25507.69230769231,51,1052000,20627.450980392157,14,606000
2020,county,48113,Dallas,48005,Angelina,TX,Rural Texas,88,1805000,20511.363636363636,87,1771000,20356.32183908046,1,34000
2020,county,48439,Tarrant,24003,Anne Arundel,MD,Baltimore,57,1943000,34087.71929824561,57,2391000,41947.36842105263,0,-448000
2020,county,48113,Dallas,24003,Anne Arundel,MD,Baltimore,55,3385000,61545.454545454544,50,2291000,45820.0,5,1094000
2020,county,48439,Tarrant,08005,Arapahoe,CO,Denver,204,12148000,59549.01960784314,175,7588000,43360.0,29,4560000
2020,county,48113,Dallas,08005,Arapahoe,CO,Denver,269,12224000,45442.37918215613,231,9804000,42441.55844155844,38,2420000
2020,county,48121,Denton,08005,Arapahoe,CO,Denver,143,5625000,39335.66433566433,138,4911000,35586.95652173913,5,714000
2020,county,48085,Collin,08005,Arapahoe,CO,Denver,191,5881000,30790.575916230366,102,4487000,43990.19607843137,89,1394000
2020,county,48439,Tarrant,51013,Arlington,VA,D.C.,50,4107000,82140.0,43,1499000,34860.46511627907,7,2608000
2020,county,48113,Dallas,51013,Arlington,VA,D.C.,123,8788000,71447.15447154471,77,4961000,64428.57142857143,46,3827000
2020,county,48085,Collin,51013,Arlington,VA,D.C.,36,2337000,64916.666666666664,28,1776000,63428.57142857143,8,561000
2020,county,48439,Tarrant,24005,Baltimore,MD,Baltimore,78,4822000,61820.51282051282,62,2073000,33435.48387096774,16,2749000
2020,county,48113,Dallas,24005,Baltimore,MD,Baltimore,90,3974000,44155.555555555555,73,2752000,37698.6301369863,17,1222000
2020,county,48439,Tarrant,24510,Baltimore city,MD,Baltimore,33,2743000,83121.21212121213,28,1145000,40892.857142857145,5,1598000
2020,county,48113,Dallas,24510,Baltimore city,MD,Baltimore,90,4731000,52566.666666666664,38,1920000,50526.31578947369,52,2811000
2020,county,48439,Tarrant,48021,Bastrop,TX,Austin,66,1670000,25303.030303030304,48,1947000,40562.5,18,-277000
2020,county,48439,Tarrant,45013,Beaufort,SC,Savannah,46,1306000,28391.304347826088,42,3136000,74666.66666666667,4,-1830000
2020,county,48439,Tarrant,48027,Bell,TX,Rural Texas,709,15815000,22306.064880112834,512,11312000,22093.75,197,4503000
2020,county,48113,Dallas,48027,Bell,TX,Rural Texas,532,12207000,22945.48872180451,505,11625000,23019.80198019802,27,582000
2020,county,48121,Denton,48027,Bell,TX,Rural Texas,236,5315000,22521.186440677968,150,4540000,30266.666666666668,86,775000
2020,county,48085,Collin,48027,Bell,TX,Rural Texas,204,6256000,30666.666666666668,132,3939000,29840.909090909092,72,2317000
2020,county,48439,Tarrant,05007,Benton,AR,Rural Arkansas,133,9661000,72639.0977443609,189,6798000,35968.25396825397,-56,2863000
2020,county,48113,Dallas,05007,Benton,AR,Rural Arkansas,148,10217000,69033.78378378379,211,11097000,52592.41706161138,-63,-880000
2020,county,48121,Denton,05007,Benton,AR,Rural Arkansas,110,7686000,69872.72727272728,112,6011000,53669.642857142855,-2,1675000
2020,county,48085,Collin,05007,Benton,AR,Rural Arkansas,190,10484000,55178.94736842105,207,11712000,56579.710144927536,-17,-1228000
2020,county,48113,Dallas,34003,Bergen,NJ,New York,103,4807000,46669.90291262136,66,2647000,40106.06060606061,37,2160000
2020,county,48085,Collin,34003,Bergen,NJ,New York,170,7543000,44370.58823529412,34,1304000,38352.94117647059,136,6239000
2020,county,48439,Tarrant,35001,Bernalillo,NM,Albuquerque,215,8647000,40218.604651162794,100,3187000,31870.0,115,5460000
2020,county,48113,Dallas,35001,Bernalillo,NM,Albuquerque,145,6337000,43703.44827586207,162,9432000,58222.22222222222,-17,-3095000
2020,county,48121,Denton,35001,Bernalillo,NM,Albuquerque,79,2701000,34189.873417721516,58,2099000,36189.65517241379,21,602000
2020,county,48085,Collin,35001,Bernalillo,NM,Albuquerque,131,5852000,44671.75572519084,46,2049000,44543.47826086957,85,3803000
2020,county,48439,Tarrant,48029,Bexar,TX,San Antonio,1325,41235000,31120.754716981133,1060,26649000,25140.56603773585,265,14586000
2020,county,48113,Dallas,48029,Bexar,TX,San Antonio,1292,58556000,45321.98142414861,1224,81928000,66934.64052287582,68,-23372000
2020,county,48121,Denton,48029,Bexar,TX,San Antonio,732,29019000,39643.44262295082,569,21903000,38493.84885764499,163,7116000
2020,county,48085,Collin,48029,Bexar,TX,San Antonio,790,33274000,42118.987341772154,491,18247000,37162.93279022403,299,15027000
2020,county,48113,Dallas,29019,Boone,MO,Columbia,66,1957000,29651.515151515152,34,1117000,32852.94117647059,32,840000
2020,county,48439,Tarrant,48035,Bosque,TX,Rural Texas,47,1302000,27702.127659574468,128,4753000,37132.8125,-81,-3451000
2020,county,48439,Tarrant,22015,Bossier Parish,LA,Rural Louisiana,167,3757000,22497.005988023953,82,2094000,25536.585365853658,85,1663000
2020,county,48113,Dallas,22015,Bossier Parish,LA,Rural Louisiana,198,7977000,40287.878787878784,104,2137000,20548.076923076922,94,5840000
2020,county,48121,Denton,22015,Bossier Parish,LA,Rural Louisiana,94,4112000,43744.68085106383,31,733000,23645.16129032258,63,3379000
2020,county,48085,Collin,22015,Bossier Parish,LA,Rural Louisiana,70,1923000,27471.428571428572,52,1398000,26884.615384615383,18,525000
2020,county,48439,Tarrant,08013,Boulder,CO,Denver,58,2909000,50155.1724137931,64,4060000,63437.5,-6,-1151000
2020,county,48113,Dallas,08013,Boulder,CO,Denver,69,4235000,61376.811594202896,92,22038000,239543.47826086957,-23,-17803000
2020,county,48085,Collin,08013,Boulder,CO,Denver,48,2229000,46437.5,39,2135000,54743.58974358974,9,94000
2020,county,48439,Tarrant,48037,Bowie,TX,Rural Texas,136,2704000,19882.352941176472,120,1973000,16441.666666666668,16,731000
2020,county,48113,Dallas,48037,Bowie,TX,Rural Texas,165,3529000,21387.878787878788,172,4657000,27075.581395348836,-7,-1128000
2020,county,48121,Denton,48037,Bowie,TX,Rural Texas,46,988000,21478.260869565216,59,1880000,31864.406779661018,-13,-892000
2020,county,48085,Collin,48037,Bowie,TX,Rural Texas,96,2073000,21593.75,63,2212000,35111.11111111111,33,-139000
2020,county,48439,Tarrant,48039,Brazoria,TX,Houston,154,5080000,32987.01298701299,216,6230000,28842.59259259259,-62,-1150000
2020,county,48113,Dallas,48039,Brazoria,TX,Houston,128,4213000,32914.0625,145,4219000,29096.55172413793,-17,-6000
2020,county,48121,Denton,48039,Brazoria,TX,Houston,115,4247000,36930.434782608696,75,2190000,29200.0,40,2057000
2020,county,48085,Collin,48039,Brazoria,TX,Houston,113,3504000,31008.849557522124,63,1743000,27666.666666666668,50,1761000
2020,county,48439,Tarrant,48041,Brazos,TX,Rural Texas,310,8044000,25948.387096774193,231,6500000,28138.528138528138,79,1544000
2020,county,48113,Dallas,48041,Brazos,TX,Rural Texas,307,9151000,29807.81758957655,222,8421000,37932.43243243243,85,730000
2020,county,48121,Denton,48041,Brazos,TX,Rural Texas,141,5289000,37510.63829787234,132,7267000,55053.030303030304,9,-1978000
2020,county,48085,Collin,48041,Brazos,TX,Rural Texas,224,6753000,30147.321428571428,149,6871000,46114.093959731545,75,-118000
2020,county,48439,Tarrant,12009,Brevard,FL,Atlantic Coast,92,3718000,40413.04347826087,110,7616000,69236.36363636363,-18,-3898000
2020,county,48113,Dallas,12009,Brevard,FL,Atlantic Coast,43,2806000,65255.813953488374,65,3439000,52907.692307692305,-22,-633000
2020,county,48121,Denton,12009,Brevard,FL,Atlantic Coast,47,1402000,29829.787234042553,53,2140000,40377.35849056604,-6,-738000
2020,county,48085,Collin,12009,Brevard,FL,Atlantic Coast,36,1328000,36888.88888888889,53,3658000,69018.8679245283,-17,-2330000
2020,county,48113,Dallas,36005,Bronx,NY,New York,126,3563000,28277.777777777777,44,910000,20681.81818181818,82,2653000
2020,county,48439,Tarrant,12011,Broward,FL,Miami,305,10281000,33708.19672131148,158,6008000,38025.3164556962,147,4273000
2020,county,48113,Dallas,12011,Broward,FL,Miami,382,19439000,50887.43455497382,243,28585000,117633.74485596707,139,-9146000
2020,county,48121,Denton,12011,Broward,FL,Miami,195,11811000,60569.230769230766,96,5601000,58343.75,99,6210000
2020,county,48085,Collin,12011,Broward,FL,Miami,325,14705000,45246.153846153844,135,6315000,46777.77777777778,190,8390000
2020,county,48439,Tarrant,48049,Brown,TX,Rural Texas,76,1461000,19223.684210526317,101,2735000,27079.20792079208,-25,-1274000
2020,county,48121,Denton,40013,Bryan,OK,Rural Oklahoma,42,1015000,24166.666666666668,68,2153000,31661.764705882353,-26,-1138000
2020,county,48085,Collin,40013,Bryan,OK,Rural Oklahoma,57,1715000,30087.719298245614,93,4019000,43215.05376344086,-36,-2304000
2020,county,48439,Tarrant,34005,Burlington,NJ,Philadelphia,60,1723000,28716.666666666668,39,2270000,58205.1282051282,21,-547000
2020,county,48113,Dallas,48053,Burnet,TX,Rural Texas,37,1143000,30891.891891891893,63,3305000,52460.31746031746,-26,-2162000
2020,county,48439,Tarrant,22017,Caddo Parish,LA,Rural Louisiana,508,9171000,18053.149606299212,191,3505000,18350.785340314134,317,5666000
2020,county,48113,Dallas,22017,Caddo Parish,LA,Rural Louisiana,641,11144000,17385.33541341654,319,5532000,17341.692789968653,322,5612000
2020,county,48121,Denton,22017,Caddo Parish,LA,Rural Louisiana,231,4812000,20831.16883116883,72,1167000,16208.333333333334,159,3645000
2020,county,48085,Collin,22017,Caddo Parish,LA,Rural Louisiana,204,4959000,24308.823529411766,87,1984000,22804.597701149425,117,2975000
2020,county,48439,Tarrant,22019,Calcasieu Parish,LA,Rural Louisiana,70,1825000,26071.428571428572,42,741000,17642.85714285714,28,1084000
2020,county,48113,Dallas,22019,Calcasieu Parish,LA,Rural Louisiana,149,2140000,14362.41610738255,53,1226000,23132.075471698114,96,914000
2020,county,48439,Tarrant,48061,Cameron,TX,Rural Texas,156,3118000,19987.17948717949,157,4754000,30280.254777070062,-1,-1636000
2020,county,48113,Dallas,48061,Cameron,TX,Rural Texas,230,4752000,20660.869565217392,188,5071000,26973.40425531915,42,-319000
2020,county,48121,Denton,48061,Cameron,TX,Rural Texas,53,2102000,39660.377358490565,76,1409000,18539.473684210527,-23,693000
2020,county,48085,Collin,48061,Cameron,TX,Rural Texas,44,1411000,32068.18181818182,37,1747000,47216.21621621621,7,-336000
2020,county,48439,Tarrant,40017,Canadian,OK,Oklahoma City,80,2434000,30425.0,91,2605000,28626.373626373625,-11,-171000
2020,county,48113,Dallas,40017,Canadian,OK,Oklahoma City,31,977000,31516.129032258064,74,2845000,38445.94594594595,-43,-1868000
2020,county,48121,Denton,40017,Canadian,OK,Oklahoma City,58,1933000,33327.58620689655,56,1829000,32660.714285714286,2,104000
2020,county,48113,Dallas,38017,Cass,ND,Rural North Dakota,39,1791000,45923.07692307692,38,1227000,32289.473684210527,1,564000
2020,county,48113,Dallas,48067,Cass,TX,Rural Texas,46,830000,18043.478260869564,41,979000,23878.048780487807,5,-149000
2020,county,48113,Dallas,45019,Charleston,SC,Charleston,71,3530000,49718.30985915493,93,8335000,89623.6559139785,-22,-4805000
2020,county,48113,Dallas,13051,Chatham,GA,Savannah,43,1679000,39046.51162790698,34,2508000,73764.70588235294,9,-829000
2020,county,48439,Tarrant,48073,Cherokee,TX,Rural Texas,37,688000,18594.594594594593,70,864000,12342.857142857143,-33,-176000
2020,county,48113,Dallas,48073,Cherokee,TX,Rural Texas,55,991000,18018.18181818182,61,2043000,33491.80327868852,-6,-1052000
2020,county,48113,Dallas,42029,Chester,PA,Philadelphia,35,1786000,51028.57142857143,38,1627000,42815.78947368421,-3,159000
2020,county,48085,Collin,42029,Chester,PA,Philadelphia,81,4838000,59728.39506172839,61,4167000,68311.47540983607,20,671000
2020,county,48113,Dallas,51041,Chesterfield,VA,Richmond,34,1201000,35323.529411764706,34,1628000,47882.35294117647,0,-427000
2020,county,48439,Tarrant,41005,Clackamas,OR,Portland,47,1907000,40574.46808510638,32,1075000,33593.75,15,832000
2020,county,48439,Tarrant,32003,Clark,NV,Las Vegas,503,13399000,26638.17097415507,406,12808000,31546.79802955665,97,591000
2020,county,48439,Tarrant,53011,Clark,WA,Portland,88,2692000,30590.909090909092,82,3321000,40500.0,6,-629000
2020,county,48113,Dallas,32003,Clark,NV,Las Vegas,530,17874000,33724.52830188679,429,14141000,32962.70396270396,101,3733000
2020,county,48113,Dallas,53011,Clark,WA,Portland,56,4647000,82982.14285714286,48,2501000,52104.166666666664,8,2146000
2020,county,48121,Denton,32003,Clark,NV,Las Vegas,351,15115000,43062.67806267806,171,9175000,53654.97076023392,180,5940000
2020,county,48085,Collin,32003,Clark,NV,Las Vegas,422,14060000,33317.5355450237,200,6855000,34275.0,222,7205000
2020,county,48439,Tarrant,29047,Clay,MO,Kansas City,73,2906000,39808.21917808219,47,2307000,49085.10638297872,26,599000
2020,county,48113,Dallas,29047,Clay,MO,Kansas City,34,1965000,57794.117647058825,39,1115000,28589.74358974359,-5,850000
2020,county,48113,Dallas,13063,Clayton,GA,Atlanta,73,1029000,14095.890410958904,43,790000,18372.093023255813,30,239000
2020,county,48439,Tarrant,40027,Cleveland,OK,Oklahoma City,167,4645000,27814.37125748503,181,3896000,21524.861878453037,-14,749000
2020,county,48113,Dallas,40027,Cleveland,OK,Oklahoma City,183,5564000,30404.371584699453,180,4470000,24833.333333333332,3,1094000
2020,county,48121,Denton,40027,Cleveland,OK,Oklahoma City,115,4471000,38878.260869565216,122,3935000,32254.09836065574,-7,536000
2020,county,48085,Collin,40027,Cleveland,OK,Oklahoma City,117,3656000,31247.863247863246,87,4868000,55954.02298850575,30,-1212000
2020,county,48439,Tarrant,13067,Cobb,GA,Atlanta,141,5373000,38106.382978723406,150,5833000,38886.666666666664,-9,-460000
2020,county,48113,Dallas,13067,Cobb,GA,Atlanta,214,6824000,31887.850467289718,179,8062000,45039.1061452514,35,-1238000
2020,county,48121,Denton,13067,Cobb,GA,Atlanta,84,3971000,47273.80952380953,71,2778000,39126.76056338028,13,1193000
2020,county,48085,Collin,13067,Cobb,GA,Atlanta,129,6141000,47604.651162790695,85,4995000,58764.705882352944,44,1146000
2020,county,48439,Tarrant,12021,Collier,FL,S.W. Florida,47,1382000,29404.255319148935,34,4546000,133705.88235294117,13,-3164000
2020,county,48113,Dallas,12021,Collier,FL,S.W. Florida,33,2008000,60848.48484848485,57,9090000,159473.68421052632,-24,-7082000
2020,county,48439,Tarrant,48085,Collin,TX,Dallas-Fort Worth,2877,106029000,36854.01459854015,3702,203119000,54867.36898973528,-825,-97090000
2020,county,48113,Dallas,48085,Collin,TX,Dallas-Fort Worth,16148,681224000,42186.27693832054,26180,1061649000,40551.90985485103,-10032,-380425000
2020,county,48121,Denton,48085,Collin,TX,Dallas-Fort Worth,14485,638461000,44077.39040386607,13322,577094000,43318.87104038433,1163,61367000
2020,county,48439,Tarrant,48091,Comal,TX,San Antonio,111,4554000,41027.02702702703,134,6916000,51611.94029850746,-23,-2362000
2020,county,48113,Dallas,48091,Comal,TX,San Antonio,81,3869000,47765.432098765436,118,6314000,53508.47457627119,-37,-2445000
2020,county,48121,Denton,48091,Comal,TX,San Antonio,82,4018000,49000.0,62,3711000,59854.83870967742,20,307000
2020,county,48085,Collin,48091,Comal,TX,San Antonio,62,4727000,76241.93548387097,86,4305000,50058.13953488372,-24,422000
2020,county,48439,Tarrant,40031,Comanche,OK,Rural Oklahoma,134,2062000,15388.059701492537,103,1487000,14436.893203883496,31,575000
2020,county,48113,Dallas,40031,Comanche,OK,Rural Oklahoma,95,1596000,16800.0,130,2610000,20076.923076923078,-35,-1014000
2020,county,48439,Tarrant,06013,Contra Costa,CA,Bay Area,183,14848000,81136.61202185792,68,4512000,66352.94117647059,115,10336000
2020,county,48113,Dallas,06013,Contra Costa,CA,Bay Area,194,16018000,82567.01030927835,76,4403000,57934.21052631579,118,11615000
2020,county,48085,Collin,06013,Contra Costa,CA,Bay Area,209,18722000,89578.94736842105,63,2230000,35396.8253968254,146,16492000
2020,county,48439,Tarrant,17031,Cook,IL,Chicago,791,38739000,48974.71554993679,388,16712000,43072.16494845361,403,22027000
2020,county,48113,Dallas,17031,Cook,IL,Chicago,1314,85531000,65092.08523592085,820,45370000,55329.26829268293,494,40161000
2020,county,48121,Denton,17031,Cook,IL,Chicago,512,24812000,48460.9375,208,9622000,46259.61538461538,304,15190000
2020,county,48085,Collin,17031,Cook,IL,Chicago,832,51585000,62001.20192307692,295,13607000,46125.42372881356,537,37978000
2020,county,48439,Tarrant,48097,Cooke,TX,Rural Texas,87,1487000,17091.954022988506,158,7482000,47354.43037974684,-71,-5995000
2020,county,48113,Dallas,48097,Cooke,TX,Rural Texas,82,2634000,32121.951219512193,149,7838000,52604.026845637585,-67,-5204000
2020,county,48121,Denton,48097,Cooke,TX,Rural Texas,511,17932000,35091.97651663405,952,51240000,53823.529411764706,-441,-33308000
2020,county,48085,Collin,48097,Cooke,TX,Rural Texas,73,2795000,38287.67123287671,93,5941000,63881.720430107525,-20,-3146000
2020,county,48439,Tarrant,48099,Coryell,TX,Rural Texas,70,1645000,23500.0,111,2355000,21216.216216216217,-41,-710000
2020,county,48113,Dallas,48099,Coryell,TX,Rural Texas,53,940000,17735.849056603773,77,931000,12090.90909090909,-24,9000
2020,county,48121,Denton,48099,Coryell,TX,Rural Texas,32,844000,26375.0,44,1385000,31477.272727272728,-12,-541000
2020,county,48439,Tarrant,37051,Cumberland,NC,Rural North Carolina,82,1442000,17585.365853658535,80,1256000,15700.0,2,186000
2020,county,48113,Dallas,37051,Cumberland,NC,Rural North Carolina,41,1025000,25000.0,47,1496000,31829.787234042553,-6,-471000
2020,county,48439,Tarrant,39035,Cuyahoga,OH,Cleveland,81,3245000,40061.72839506173,89,4179000,46955.05617977528,-8,-934000
2020,county,48113,Dallas,39035,Cuyahoga,OH,Cleveland,120,8077000,67308.33333333333,107,4668000,43626.168224299065,13,3409000
2020,county,48085,Collin,39035,Cuyahoga,OH,Cleveland,139,5858000,42143.88489208633,65,2401000,36938.46153846154,74,3457000
2020,county,48439,Tarrant,27037,Dakota,MN,Minneapolis,53,1962000,37018.8679245283,42,1764000,42000.0,11,198000
2020,county,48113,Dallas,27037,Dakota,MN,Minneapolis,68,2264000,33294.117647058825,58,2181000,37603.44827586207,10,83000
2020,county,48439,Tarrant,48113,Dallas,TX,Dallas-Fort Worth,26832,788567000,29389.0503875969,20137,619614000,30769.926006853057,6695,168953000
2020,county,48121,Denton,48113,Dallas,TX,Dallas-Fort Worth,18519,703224000,37973.10869917382,11203,400988000,35792.91261269303,7316,302236000
2020,county,48085,Collin,48113,Dallas,TX,Dallas-Fort Worth,26180,1061649000,40551.90985485103,16148,681224000,42186.27693832054,10032,380425000
2020,county,48439,Tarrant,55025,Dane,WI,Madison,59,2203000,37338.983050847455,48,2011000,41895.833333333336,11,192000
2020,county,48113,Dallas,55025,Dane,WI,Madison,103,6200000,60194.17475728155,70,2375000,33928.57142857143,33,3825000
2020,county,48439,Tarrant,47037,Davidson,TN,Nashville,167,5868000,35137.7245508982,118,3413000,28923.728813559323,49,2455000
2020,county,48113,Dallas,47037,Davidson,TN,Nashville,267,28018000,104936.32958801498,266,25005000,94003.75939849624,1,3013000
2020,county,48121,Denton,47037,Davidson,TN,Nashville,57,4044000,70947.36842105263,50,2863000,57260.0,7,1181000
2020,county,48085,Collin,47037,Davidson,TN,Nashville,87,3640000,41839.08045977011,80,5610000,70125.0,7,-1970000
2020,county,48439,Tarrant,49011,Davis,UT,Rural Utah,67,1724000,25731.34328358209,67,1751000,26134.328358208953,0,-27000
2020,county,48439,Tarrant,13089,DeKalb,GA,Atlanta,125,3075000,24600.0,72,2898000,40250.0,53,177000
2020,county,48113,Dallas,13089,DeKalb,GA,Atlanta,250,11852000,47408.0,158,7960000,50379.74683544304,92,3892000
2020,county,48121,Denton,13089,DeKalb,GA,Atlanta,52,2645000,50865.38461538462,27,1117000,41370.37037037037,25,1528000
2020,county,48085,Collin,13089,DeKalb,GA,Atlanta,73,3569000,48890.41095890411,69,1925000,27898.55072463768,4,1644000
2020,county,48439,Tarrant,28033,DeSoto,MS,Memphis,43,889000,20674.418604651164,79,1959000,24797.46835443038,-36,-1070000
2020,county,48439,Tarrant,48121,Denton,TX,Dallas-Fort Worth,7793,306930000,39385.34582317464,11367,489719000,43082.51957420603,-3574,-182789000
2020,county,48113,Dallas,48121,Denton,TX,Dallas-Fort Worth,11203,400988000,35792.91261269303,18519,703224000,37973.10869917382,-7316,-302236000
2020,county,48085,Collin,48121,Denton,TX,Dallas-Fort Worth,13322,577094000,43318.87104038433,14485,638461000,44077.39040386607,-1163,-61367000
2020,county,48439,Tarrant,08031,Denver,CO,Denver,191,8904000,46617.80104712042,228,11476000,50333.333333333336,-37,-2572000
2020,county,48113,Dallas,08031,Denver,CO,Denver,301,22245000,73903.65448504983,461,33211000,72041.2147505423,-160,-10966000
2020,county,48121,Denton,08031,Denver,CO,Denver,93,5190000,55806.45161290323,119,6266000,52655.46218487395,-26,-1076000
2020,county,48085,Collin,08031,Denver,CO,Denver,110,5126000,46600.0,114,6263000,54938.59649122807,-4,-1137000
2020,county,48439,Tarrant,11001,District of Columbia,DC,D.C.,79,4498000,56936.70886075949,71,3795000,53450.704225352114,8,703000
2020,county,48113,Dallas,11001,District of Columbia,DC,D.C.,197,19314000,98040.60913705584,139,11957000,86021.58273381295,58,7357000
2020,county,48121,Denton,11001,District of Columbia,DC,D.C.,26,1673000,64346.153846153844,28,1907000,68107.14285714286,-2,-234000
2020,county,48085,Collin,11001,District of Columbia,DC,D.C.,47,4356000,92680.85106382979,36,1997000,55472.22222222222,11,2359000
2020,county,48439,Tarrant,31055,Douglas,NE,Omaha,156,7549000,48391.02564102564,114,2826000,24789.473684210527,42,4723000
2020,county,48439,Tarrant,08035,Douglas,CO,Denver,143,7979000,55797.20279720279,163,8636000,52981.59509202454,-20,-657000
2020,county,48113,Dallas,31055,Douglas,NE,Omaha,165,6992000,42375.757575757576,151,5551000,36761.58940397351,14,1441000
2020,county,48113,Dallas,08035,Douglas,CO,Denver,107,8905000,83224.29906542056,97,6805000,70154.63917525773,10,2100000
2020,county,48121,Denton,08035,Douglas,CO,Denver,162,9699000,59870.37037037037,138,8374000,60681.159420289856,24,1325000
2020,county,48121,Denton,31055,Douglas,NE,Omaha,96,4694000,48895.833333333336,46,2794000,60739.13043478261,50,1900000
2020,county,48085,Collin,08035,Douglas,CO,Denver,192,10774000,56114.583333333336,149,10983000,73711.40939597315,43,-209000
2020,county,48085,Collin,31055,Douglas,NE,Omaha,84,3298000,39261.90476190476,44,1965000,44659.09090909091,40,1333000
2020,county,48439,Tarrant,17043,DuPage,IL,Chicago,182,8627000,47401.0989010989,60,3085000,51416.666666666664,122,5542000
2020,county,48113,Dallas,17043,DuPage,IL,Chicago,186,15924000,85612.90322580645,117,7367000,62965.81196581197,69,8557000
2020,county,48121,Denton,17043,DuPage,IL,Chicago,155,10500000,67741.93548387097,57,2463000,43210.52631578947,98,8037000
2020,county,48085,Collin,17043,DuPage,IL,Chicago,325,13538000,41655.38461538462,103,4285000,41601.94174757282,222,9253000
2020,county,48113,Dallas,37063,Durham,NC,Raleigh,89,7805000,87696.62921348315,94,4109000,43712.765957446805,-5,3696000
2020,county,48085,Collin,37063,Durham,NC,Raleigh,52,1952000,37538.46153846154,26,972000,37384.61538461538,26,980000
2020,county,48439,Tarrant,12031,Duval,FL,Jacksonville,138,3643000,26398.55072463768,152,5825000,38322.36842105263,-14,-2182000
2020,county,48113,Dallas,12031,Duval,FL,Jacksonville,182,11102000,61000.0,153,7553000,49366.013071895424,29,3549000
2020,county,48121,Denton,12031,Duval,FL,Jacksonville,94,3243000,34500.0,31,1314000,42387.096774193546,63,1929000
2020,county,48085,Collin,12031,Duval,FL,Jacksonville,97,4416000,45525.77319587629,83,4148000,49975.903614457835,14,268000
2020,county,48439,Tarrant,22033,East Baton Rouge Parish,LA,Rural Louisiana,182,4690000,25769.23076923077,79,1729000,21886.07594936709,103,2961000
2020,county,48113,Dallas,22033,East Baton Rouge Parish,LA,Rural Louisiana,251,7318000,29155.378486055775,130,2408000,18523.076923076922,121,4910000
2020,county,48121,Denton,22033,East Baton Rouge Parish,LA,Rural Louisiana,95,3129000,32936.84210526316,37,670000,18108.108108108107,58,2459000
2020,county,48085,Collin,22033,East Baton Rouge Parish,LA,Rural Louisiana,97,4194000,43237.113402061856,47,2299000,48914.89361702128,50,1895000
2020,county,48439,Tarrant,48133,Eastland,TX,Rural Texas,48,2154000,44875.0,98,2084000,21265.30612244898,-50,70000
2020,county,48439,Tarrant,48135,Ector,TX,Rural Texas,331,8496000,25667.673716012083,195,5099000,26148.71794871795,136,3397000
2020,county,48113,Dallas,48135,Ector,TX,Rural Texas,214,6544000,30579.439252336448,156,3545000,22724.358974358973,58,2999000
2020,county,48121,Denton,48135,Ector,TX,Rural Texas,91,5236000,57538.46153846154,58,1673000,28844.827586206895,33,3563000
2020,county,48439,Tarrant,48141,El Paso,TX,El Paso,633,14852000,23462.875197472353,468,11101000,23720.08547008547,165,3751000
2020,county,48439,Tarrant,08041,El Paso,CO,Colorado Springs,332,9225000,27786.14457831325,372,11300000,30376.344086021505,-40,-2075000
2020,county,48113,Dallas,48141,El Paso,TX,El Paso,567,15724000,27731.922398589064,484,13369000,27621.900826446283,83,2355000
2020,county,48113,Dallas,08041,El Paso,CO,Colorado Springs,200,5996000,29980.0,295,10684000,36216.94915254237,-95,-4688000
2020,county,48121,Denton,48141,El Paso,TX,El Paso,197,5002000,25390.862944162436,169,4750000,28106.508875739644,28,252000
2020,county,48121,Denton,08041,El Paso,CO,Colorado Springs,152,5473000,36006.57894736842,215,8508000,39572.09302325582,-63,-3035000
2020,county,48085,Collin,48141,El Paso,TX,El Paso,230,9691000,42134.782608695656,193,5112000,26487.04663212435,37,4579000
2020,county,48085,Collin,08041,El Paso,CO,Colorado Springs,190,5585000,29394.736842105263,203,8968000,44177.33990147783,-13,-3383000
2020,county,48439,Tarrant,48139,Ellis,TX,Dallas-Fort Worth,1426,42212000,29601.683029453015,3027,101580000,33557.9781962339,-1601,-59368000
2020,county,48113,Dallas,48139,Ellis,TX,Dallas-Fort Worth,2783,54104000,19440.89112468559,7183,217687000,30305.86106083809,-4400,-163583000
2020,county,48121,Denton,48139,Ellis,TX,Dallas-Fort Worth,370,10649000,28781.08108108108,417,15683000,37609.11270983214,-47,-5034000
2020,county,48085,Collin,48139,Ellis,TX,Dallas-Fort Worth,321,9168000,28560.747663551403,319,12956000,40614.42006269593,2,-3788000
2020,county,48439,Tarrant,48143,Erath,TX,Rural Texas,209,5397000,25822.966507177032,207,7509000,36275.362318840576,2,-2112000
2020,county,48113,Dallas,48143,Erath,TX,Rural Texas,82,1290000,15731.707317073171,69,2087000,30246.376811594204,13,-797000
2020,county,48121,Denton,48143,Erath,TX,Rural Texas,33,908000,27515.151515151516,34,783000,23029.41176470588,-1,125000
2020,county,48439,Tarrant,36029,Erie,NY,Buffalo,82,2087000,25451.219512195123,54,1666000,30851.85185185185,28,421000
2020,county,48113,Dallas,36029,Erie,NY,Buffalo,91,2740000,30109.89010989011,47,2201000,46829.78723404255,44,539000
2020,county,48439,Tarrant,12033,Escambia,FL,FL Panhandle,99,2660000,26868.68686868687,73,1868000,25589.04109589041,26,792000
2020,county,48113,Dallas,12033,Escambia,FL,FL Panhandle,53,1482000,27962.264150943396,66,2908000,44060.606060606064,-13,-1426000
2020,county,48113,Dallas,34013,Essex,NJ,New York,111,4448000,40072.07207207207,41,2083000,50804.87804878049,70,2365000
2020,county,48113,Dallas,25009,Essex,MA,Boston,48,1475000,30729.166666666668,34,2092000,61529.41176470588,14,-617000
2020,county,48439,Tarrant,51059,Fairfax,VA,D.C.,237,11124000,46936.70886075949,106,7553000,71254.71698113208,131,3571000
2020,county,48113,Dallas,51059,Fairfax,VA,D.C.,296,14032000,47405.40540540541,247,11541000,46724.6963562753,49,2491000
2020,county,48121,Denton,51059,Fairfax,VA,D.C.,195,11717000,60087.179487179485,54,2698000,49962.96296296296,141,9019000
2020,county,48085,Collin,51059,Fairfax,VA,D.C.,305,16644000,54570.49180327869,146,7512000,51452.05479452055,159,9132000
2020,county,48439,Tarrant,09001,Fairfield,CT,New York,73,6919000,94780.82191780822,43,998000,23209.302325581397,30,5921000
2020,county,48113,Dallas,09001,Fairfield,CT,New York,158,56637000,358462.0253164557,113,10253000,90734.51327433628,45,46384000
2020,county,48085,Collin,09001,Fairfield,CT,New York,132,9641000,73037.87878787878,56,4915000,87767.85714285714,76,4726000
2020,county,48439,Tarrant,48147,Fannin,TX,Rural Texas,34,833000,24500.0,92,2410000,26195.652173913044,-58,-1577000
2020,county,48113,Dallas,48147,Fannin,TX,Rural Texas,80,2222000,27775.0,220,7949000,36131.818181818184,-140,-5727000
2020,county,48121,Denton,48147,Fannin,TX,Rural Texas,59,1368000,23186.4406779661,154,4934000,32038.96103896104,-95,-3566000
2020,county,48085,Collin,48147,Fannin,TX,Rural Texas,288,7960000,27638.88888888889,668,18631000,27890.71856287425,-380,-10671000
2020,county,48113,Dallas,05045,Faulkner,AR,Little Rock,69,1504000,21797.101449275364,44,1222000,27772.727272727272,25,282000
2020,county,48113,Dallas,37067,Forsyth,NC,Greensboro,63,2227000,35349.206349206346,45,1518000,33733.333333333336,18,709000
2020,county,48113,Dallas,13117,Forsyth,GA,Atlanta,57,2838000,49789.47368421053,50,4687000,93740.0,7,-1849000
2020,county,48439,Tarrant,48157,Fort Bend,TX,Houston,366,16248000,44393.44262295082,370,14227000,38451.35135135135,-4,2021000
2020,county,48113,Dallas,48157,Fort Bend,TX,Houston,405,18804000,46429.62962962963,467,19376000,41490.36402569593,-62,-572000
2020,county,48121,Denton,48157,Fort Bend,TX,Houston,274,13190000,48138.686131386865,226,10205000,45154.86725663717,48,2985000
2020,county,48085,Collin,48157,Fort Bend,TX,Houston,471,20941000,44460.72186836518,291,11423000,39254.29553264605,180,9518000
2020,county,48439,Tarrant,39049,Franklin,OH,Columbus,120,4196000,34966.666666666664,185,4995000,27000.0,-65,-799000
2020,county,48113,Dallas,39049,Franklin,OH,Columbus,247,8829000,35744.93927125506,193,10007000,51849.74093264249,54,-1178000
2020,county,48113,Dallas,48159,Franklin,TX,Rural Texas,33,911000,27606.060606060608,69,7025000,101811.59420289854,-36,-6114000
2020,county,48121,Denton,39049,Franklin,OH,Columbus,130,5821000,44776.92307692308,38,1736000,45684.21052631579,92,4085000
2020,county,48085,Collin,39049,Franklin,OH,Columbus,240,9035000,37645.833333333336,68,8350000,122794.11764705883,172,685000
2020,county,48113,Dallas,48161,Freestone,TX,Rural Texas,41,673000,16414.634146341465,68,1787000,26279.41176470588,-27,-1114000
2020,county,48439,Tarrant,06019,Fresno,CA,Fresno,138,2244000,16260.869565217392,62,1865000,30080.645161290322,76,379000
2020,county,48113,Dallas,06019,Fresno,CA,Fresno,95,2047000,21547.36842105263,59,1780000,30169.491525423728,36,267000
2020,county,48439,Tarrant,13121,Fulton,GA,Atlanta,163,8695000,53343.55828220859,180,8318000,46211.11111111111,-17,377000
2020,county,48113,Dallas,13121,Fulton,GA,Atlanta,372,29644000,79688.17204301075,421,41345000,98206.65083135392,-49,-11701000
2020,county,48121,Denton,13121,Fulton,GA,Atlanta,113,7327000,64840.70796460177,111,5845000,52657.657657657655,2,1482000
2020,county,48085,Collin,13121,Fulton,GA,Atlanta,271,16122000,59490.77490774908,179,9997000,55849.16201117318,92,6125000
2020,county,48439,Tarrant,48167,Galveston,TX,Houston,192,6739000,35098.958333333336,218,11009000,50500.0,-26,-4270000
2020,county,48113,Dallas,48167,Galveston,TX,Houston,173,5934000,34300.57803468208,217,13182000,60746.543778801846,-44,-7248000
2020,county,48121,Denton,48167,Galveston,TX,Houston,91,3957000,43483.51648351648,126,5381000,42706.34920634921,-35,-1424000
2020,county,48085,Collin,48167,Galveston,TX,Houston,88,2959000,33625.0,89,4494000,50494.38202247191,-1,-1535000
2020,county,48439,Tarrant,05051,Garland,AR,Rural Arkansas,40,1430000,35750.0,88,2678000,30431.81818181818,-48,-1248000
2020,county,48113,Dallas,05051,Garland,AR,Rural Arkansas,46,1651000,35891.30434782609,60,2238000,37300.0,-14,-587000
2020,county,48439,Tarrant,20061,Geary,KS,Rural Kansas,53,967000,18245.283018867925,45,729000,16200.0,8,238000
2020,county,48439,Tarrant,26049,Genesee,MI,Rural Michigan,99,1350000,13636.363636363636,70,1177000,16814.285714285714,29,173000
2020,county,48113,Dallas,26049,Genesee,MI,Rural Michigan,54,913000,16907.40740740741,44,737000,16750.0,10,176000
2020,county,48439,Tarrant,48181,Grayson,TX,Rural Texas,233,5862000,25158.798283261804,382,12526000,32790.575916230366,-149,-6664000
2020,county,48113,Dallas,48181,Grayson,TX,Rural Texas,412,11134000,27024.271844660194,714,25113000,35172.268907563026,-302,-13979000
2020,county,48121,Denton,48181,Grayson,TX,Rural Texas,484,13037000,26935.95041322314,1053,34871000,33115.85944919278,-569,-21834000
2020,county,48085,Collin,48181,Grayson,TX,Rural Texas,1097,38547000,35138.55970829535,2416,87678000,36290.562913907284,-1319,-49131000
2020,county,48439,Tarrant,29077,Greene,MO,Rural Missouri,73,1882000,25780.821917808218,66,1427000,21621.21212121212,7,455000
2020,county,48113,Dallas,29077,Greene,MO,Rural Missouri,45,1736000,38577.77777777778,64,1734000,27093.75,-19,2000
2020,county,48439,Tarrant,45045,Greenville,SC,Greenville,50,2283000,45660.0,70,2714000,38771.42857142857,-20,-431000
2020,county,48113,Dallas,45045,Greenville,SC,Greenville,57,3598000,63122.80701754386,45,1969000,43755.555555555555,12,1629000
2020,county,48439,Tarrant,48183,Gregg,TX,Rural Texas,182,3610000,19835.164835164836,156,3540000,22692.30769230769,26,70000
2020,county,48113,Dallas,48183,Gregg,TX,Rural Texas,343,7722000,22513.119533527697,298,5802000,19469.798657718122,45,1920000
2020,county,48121,Denton,48183,Gregg,TX,Rural Texas,95,2500000,26315.78947368421,79,3296000,41721.51898734177,16,-796000
2020,county,48085,Collin,48183,Gregg,TX,Rural Texas,138,4587000,33239.13043478261,92,3174000,34500.0,46,1413000
2020,county,48439,Tarrant,48187,Guadalupe,TX,San Antonio,102,3647000,35754.901960784315,98,3529000,36010.204081632655,4,118000
2020,county,48113,Dallas,48187,Guadalupe,TX,San Antonio,77,3068000,39844.155844155845,80,2401000,30012.5,-3,667000
2020,county,48439,Tarrant,37081,Guilford,NC,Greensboro,93,3257000,35021.50537634409,54,1853000,34314.81481481482,39,1404000
2020,county,48113,Dallas,37081,Guilford,NC,Greensboro,54,1357000,25129.62962962963,75,2942000,39226.666666666664,-21,-1585000
2020,county,48439,Tarrant,13135,Gwinnett,GA,Atlanta,183,5390000,29453.551912568306,128,3622000,28296.875,55,1768000
2020,county,48113,Dallas,13135,Gwinnett,GA,Atlanta,163,6726000,41263.8036809816,180,4887000,27150.0,-17,1839000
2020,county,48121,Denton,13135,Gwinnett,GA,Atlanta,100,3586000,35860.0,71,2144000,30197.183098591548,29,1442000
2020,county,48085,Collin,13135,Gwinnett,GA,Atlanta,142,4100000,28873.23943661972,115,5891000,51226.086956521736,27,-1791000
2020,county,48439,Tarrant,39061,Hamilton,OH,Cincinnati,48,2016000,42000.0,62,2104000,33935.48387096774,-14,-88000
2020,county,48439,Tarrant,18057,Hamilton,IN,Indianapolis,58,2192000,37793.10344827586,41,2611000,63682.92682926829,17,-419000
2020,county,48439,Tarrant,47065,Hamilton,TN,Chattanooga,49,1284000,26204.081632653062,39,2035000,52179.48717948718,10,-751000
2020,county,48113,Dallas,39061,Hamilton,OH,Cincinnati,107,4764000,44523.36448598131,65,3583000,55123.07692307692,42,1181000
2020,county,48113,Dallas,18057,Hamilton,IN,Indianapolis,59,3761000,63745.76271186441,68,3926000,57735.294117647056,-9,-165000
2020,county,48113,Dallas,47065,Hamilton,TN,Chattanooga,36,1861000,51694.444444444445,54,5436000,100666.66666666667,-18,-3575000
2020,county,48439,Tarrant,48201,Harris,TX,Houston,2268,83769000,36935.18518518518,2066,68900000,33349.46757018393,202,14869000
2020,county,48113,Dallas,48201,Harris,TX,Houston,3450,171246000,49636.52173913043,3176,138660000,43658.690176322416,274,32586000
2020,county,48121,Denton,48201,Harris,TX,Houston,1051,44539000,42377.735490009516,842,41849000,49701.90023752969,209,2690000
2020,county,48085,Collin,48201,Harris,TX,Houston,1457,67957000,46641.7295813315,991,42228000,42611.503531786075,466,25729000
2020,county,48439,Tarrant,48203,Harrison,TX,Rural Texas,97,2046000,21092.78350515464,95,2972000,31284.21052631579,2,-926000
2020,county,48439,Tarrant,28047,Harrison,MS,Gulfport-Biloxi,61,1030000,16885.245901639344,56,1139000,20339.285714285714,5,-109000
2020,county,48113,Dallas,48203,Harrison,TX,Rural Texas,132,2885000,21856.060606060608,123,2397000,19487.80487804878,9,488000
2020,county,48113,Dallas,28047,Harrison,MS,Gulfport-Biloxi,95,1355000,14263.157894736842,39,640000,16410.25641025641,56,715000
2020,county,48439,Tarrant,09003,Hartford,CT,Hartford,78,3103000,39782.05128205128,54,1513000,28018.51851851852,24,1590000
2020,county,48113,Dallas,09003,Hartford,CT,Hartford,94,5793000,61627.65957446808,80,3698000,46225.0,14,2095000
2020,county,48439,Tarrant,48209,Hays,TX,Austin,205,5294000,25824.39024390244,220,15734000,71518.18181818182,-15,-10440000
2020,county,48113,Dallas,48209,Hays,TX,Austin,190,5372000,28273.684210526317,260,12960000,49846.153846153844,-70,-7588000
2020,county,48121,Denton,48209,Hays,TX,Austin,113,3221000,28504.424778761062,129,4668000,36186.04651162791,-16,-1447000
2020,county,48085,Collin,48209,Hays,TX,Austin,113,4093000,36221.238938053095,128,6266000,48953.125,-15,-2173000
2020,county,48439,Tarrant,48213,Henderson,TX,Rural Texas,174,4948000,28436.7816091954,328,13160000,40121.95121951219,-154,-8212000
2020,county,48113,Dallas,48213,Henderson,TX,Rural Texas,292,16167000,55366.438356164384,871,38994000,44769.230769230766,-579,-22827000
2020,county,48121,Denton,48213,Henderson,TX,Rural Texas,81,2846000,35135.8024691358,143,9434000,65972.02797202797,-62,-6588000
2020,county,48085,Collin,48213,Henderson,TX,Rural Texas,95,4097000,43126.31578947369,170,10664000,62729.41176470588,-75,-6567000
2020,county,48439,Tarrant,27053,Hennepin,MN,Minneapolis,212,10142000,47839.622641509435,130,4261000,32776.92307692308,82,5881000
2020,county,48113,Dallas,27053,Hennepin,MN,Minneapolis,312,17878000,57301.282051282054,162,9180000,56666.666666666664,150,8698000
2020,county,48121,Denton,27053,Hennepin,MN,Minneapolis,131,7362000,56198.47328244275,60,3114000,51900.0,71,4248000
2020,county,48085,Collin,27053,Hennepin,MN,Minneapolis,279,12183000,43666.666666666664,76,6553000,86223.68421052632,203,5630000
2020,county,48113,Dallas,51087,Henrico,VA,Richmond,80,5040000,63000.0,69,3595000,52101.44927536232,11,1445000
2020,county,48085,Collin,51087,Henrico,VA,Richmond,89,3875000,43539.32584269663,58,2881000,49672.41379310345,31,994000
2020,county,48439,Tarrant,48215,Hidalgo,TX,Rural Texas,235,5636000,23982.978723404256,242,5729000,23673.553719008265,-7,-93000
2020,county,48113,Dallas,48215,Hidalgo,TX,Rural Texas,372,6715000,18051.075268817203,333,9923000,29798.798798798798,39,-3208000
2020,county,48121,Denton,48215,Hidalgo,TX,Rural Texas,77,2402000,31194.805194805194,96,3048000,31750.0,-19,-646000
2020,county,48085,Collin,48215,Hidalgo,TX,Rural Texas,136,4462000,32808.82352941176,79,2202000,27873.41772151899,57,2260000
2020,county,48439,Tarrant,48217,Hill,TX,Rural Texas,170,6625000,38970.58823529412,352,9524000,27056.81818181818,-182,-2899000
2020,county,48113,Dallas,48217,Hill,TX,Rural Texas,115,1615000,14043.478260869566,175,5220000,29828.571428571428,-60,-3605000
2020,county,48439,Tarrant,12057,Hillsborough,FL,Tampa,182,5480000,30109.89010989011,233,7966000,34188.841201716736,-51,-2486000
2020,county,48113,Dallas,12057,Hillsborough,FL,Tampa,313,16295000,52060.70287539936,339,15397000,45418.8790560472,-26,898000
2020,county,48113,Dallas,33011,Hillsborough,NH,Rural New Hampshire,45,1049000,23311.11111111111,49,3210000,65510.204081632655,-4,-2161000
2020,county,48121,Denton,12057,Hillsborough,FL,Tampa,162,8994000,55518.51851851852,128,5592000,43687.5,34,3402000
2020,county,48085,Collin,12057,Hillsborough,FL,Tampa,177,7775000,43926.55367231638,170,8298000,48811.76470588235,7,-523000
2020,county,48439,Tarrant,28049,Hinds,MS,Jackson,300,3668000,12226.666666666666,77,1033000,13415.584415584415,223,2635000
2020,county,48113,Dallas,28049,Hinds,MS,Jackson,296,4557000,15395.27027027027,89,1606000,18044.94382022472,207,2951000
2020,county,48439,Tarrant,15003,Honolulu,HI,Rural Hawaii,269,7635000,28382.899628252788,144,4385000,30451.38888888889,125,3250000
2020,county,48113,Dallas,15003,Honolulu,HI,Rural Hawaii,174,5291000,30408.045977011494,102,4129000,40480.39215686275,72,1162000
2020,county,48121,Denton,15003,Honolulu,HI,Rural Hawaii,118,3144000,26644.06779661017,37,1618000,43729.72972972973,81,1526000
2020,county,48085,Collin,15003,Honolulu,HI,Rural Hawaii,185,6229000,33670.27027027027,64,2257000,35265.625,121,3972000
2020,county,48439,Tarrant,48221,Hood,TX,Rural Texas,752,23657000,31458.77659574468,1414,47845000,33836.63366336634,-662,-24188000
2020,county,48113,Dallas,48221,Hood,TX,Rural Texas,144,3510000,24375.0,200,10914000,54570.0,-56,-7404000
2020,county,48121,Denton,48221,Hood,TX,Rural Texas,109,5860000,53761.46788990826,145,11280000,77793.10344827586,-36,-5420000
2020,county,48439,Tarrant,48223,Hopkins,TX,Rural Texas,51,1075000,21078.43137254902,69,2075000,30072.463768115944,-18,-1000000
2020,county,48113,Dallas,48223,Hopkins,TX,Rural Texas,131,2817000,21503.81679389313,162,4612000,28469.135802469136,-31,-1795000
2020,county,48085,Collin,48223,Hopkins,TX,Rural Texas,58,1473000,25396.55172413793,106,3629000,34235.84905660377,-48,-2156000
2020,county,48439,Tarrant,45051,Horry,SC,Rural South Carolina,29,913000,31482.758620689656,45,1666000,37022.22222222222,-16,-753000
2020,county,48113,Dallas,24027,Howard,MD,Baltimore,52,2917000,56096.153846153844,65,2504000,38523.07692307692,-13,413000
2020,county,48439,Tarrant,34017,Hudson,NJ,New York,94,3353000,35670.21276595745,59,2637000,44694.91525423729,35,716000
2020,county,48113,Dallas,34017,Hudson,NJ,New York,288,31496000,109361.11111111111,150,8684000,57893.333333333336,138,22812000
2020,county,48085,Collin,34017,Hudson,NJ,New York,225,15272000,67875.55555555556,35,2310000,66000.0,190,12962000
2020,county,48439,Tarrant,48231,Hunt,TX,Dallas-Fort Worth,183,4191000,22901.639344262294,243,6614000,27218.106995884773,-60,-2423000
2020,county,48113,Dallas,48231,Hunt,TX,Dallas-Fort Worth,929,19041000,20496.232508073197,2051,53868000,26264.26133593369,-1122,-34827000
2020,county,48121,Denton,48231,Hunt,TX,Dallas-Fort Worth,162,3400000,20987.654320987655,287,7477000,26052.264808362368,-125,-4077000
2020,county,48085,Collin,48231,Hunt,TX,Dallas-Fort Worth,757,18843000,24891.677675033025,1150,32240000,28034.782608695652,-393,-13397000
2020,county,48439,Tarrant,48237,Jack,TX,Rural Texas,39,556000,14256.410256410256,100,4258000,42580.0,-61,-3702000
2020,county,48439,Tarrant,29095,Jackson,MO,Kansas City,224,4745000,21183.035714285714,159,3854000,24238.993710691822,65,891000
2020,county,48113,Dallas,29095,Jackson,MO,Kansas City,307,8926000,29074.918566775243,136,5059000,37198.529411764706,171,3867000
2020,county,48121,Denton,29095,Jackson,MO,Kansas City,83,2438000,29373.493975903613,43,1588000,36930.232558139534,40,850000
2020,county,48085,Collin,29095,Jackson,MO,Kansas City,103,3826000,37145.63106796116,66,2615000,39621.21212121212,37,1211000
2020,county,48439,Tarrant,48245,Jefferson,TX,Rural Texas,159,4482000,28188.67924528302,107,2310000,21588.78504672897,52,2172000
2020,county,48439,Tarrant,08059,Jefferson,CO,Denver,151,8274000,54794.70198675497,132,7389000,55977.27272727273,19,885000
2020,county,48439,Tarrant,01073,Jefferson,AL,Birmingham,93,4666000,50172.04301075269,51,1302000,25529.41176470588,42,3364000
2020,county,48439,Tarrant,21111,Jefferson,KY,Louisville,81,2023000,24975.30864197531,77,2532000,32883.11688311688,4,-509000
2020,county,48113,Dallas,48245,Jefferson,TX,Rural Texas,204,5901000,28926.470588235294,146,3449000,23623.287671232876,58,2452000
2020,county,48113,Dallas,01073,Jefferson,AL,Birmingham,129,5261000,40782.94573643411,106,6335000,59764.15094339623,23,-1074000
2020,county,48113,Dallas,21111,Jefferson,KY,Louisville,135,5388000,39911.11111111111,128,6786000,53015.625,7,-1398000
2020,county,48113,Dallas,08059,Jefferson,CO,Denver,80,3455000,43187.5,148,8289000,56006.75675675676,-68,-4834000
2020,county,48113,Dallas,05069,Jefferson,AR,Rural Arkansas,57,910000,15964.912280701754,44,655000,14886.363636363636,13,255000
2020,county,48121,Denton,08059,Jefferson,CO,Denver,78,3156000,40461.53846153846,77,3415000,44350.64935064935,1,-259000
2020,county,48121,Denton,48245,Jefferson,TX,Rural Texas,57,2492000,43719.29824561404,30,769000,25633.333333333332,27,1723000
2020,county,48121,Denton,21111,Jefferson,KY,Louisville,52,1986000,38192.307692307695,42,1822000,43380.95238095238,10,164000
2020,county,48085,Collin,08059,Jefferson,CO,Denver,107,5821000,54401.86915887851,107,6024000,56299.06542056075,0,-203000
2020,county,48085,Collin,21111,Jefferson,KY,Louisville,81,4399000,54308.641975308645,37,3383000,91432.43243243243,44,1016000
2020,county,48439,Tarrant,22051,Jefferson Parish,LA,New Orleans,123,2525000,20528.455284552845,78,1781000,22833.333333333332,45,744000
2020,county,48113,Dallas,22051,Jefferson Parish,LA,New Orleans,177,4160000,23502.824858757063,103,3440000,33398.05825242718,74,720000
2020,county,48085,Collin,22051,Jefferson Parish,LA,New Orleans,103,2688000,26097.087378640776,37,930000,25135.135135135137,66,1758000
2020,county,48439,Tarrant,48251,Johnson,TX,Dallas-Fort Worth,4300,106272000,24714.418604651164,7981,228779000,28665.455456709686,-3681,-122507000
2020,county,48439,Tarrant,20091,Johnson,KS,Kansas City,176,17292000,98250.0,133,5776000,43428.57142857143,43,11516000
2020,county,48113,Dallas,48251,Johnson,TX,Dallas-Fort Worth,542,13250000,24446.494464944648,1065,28367000,26635.68075117371,-523,-15117000
2020,county,48113,Dallas,20091,Johnson,KS,Kansas City,212,10190000,48066.03773584906,178,11534000,64797.752808988764,34,-1344000
2020,county,48121,Denton,48251,Johnson,TX,Dallas-Fort Worth,183,6080000,33224.043715846994,259,7949000,30691.11969111969,-76,-1869000
2020,county,48121,Denton,20091,Johnson,KS,Kansas City,178,7425000,41713.48314606742,100,3622000,36220.0,78,3803000
2020,county,48085,Collin,20091,Johnson,KS,Kansas City,241,12564000,52132.78008298755,132,6212000,47060.606060606064,109,6352000
2020,county,48085,Collin,48251,Johnson,TX,Dallas-Fort Worth,97,2954000,30453.60824742268,137,5121000,37379.562043795624,-40,-2167000
2020,county,48439,Tarrant,17089,Kane,IL,Chicago,116,2643000,22784.48275862069,59,2755000,46694.91525423729,57,-112000
2020,county,48113,Dallas,17089,Kane,IL,Chicago,74,2748000,37135.13513513513,37,1284000,34702.7027027027,37,1464000
2020,county,48439,Tarrant,48257,Kaufman,TX,Dallas-Fort Worth,442,11597000,26237.556561085974,815,20156000,24731.28834355828,-373,-8559000
2020,county,48113,Dallas,48257,Kaufman,TX,Dallas-Fort Worth,2823,66805000,23664.541268154444,9422,215118000,22831.458289110593,-6599,-148313000
2020,county,48121,Denton,48257,Kaufman,TX,Dallas-Fort Worth,306,8306000,27143.7908496732,555,16716000,30118.91891891892,-249,-8410000
2020,county,48085,Collin,48257,Kaufman,TX,Dallas-Fort Worth,584,17974000,30777.397260273974,733,22471000,30656.207366984992,-149,-4497000
2020,county,48439,Tarrant,26081,Kent,MI,Rural Michigan,104,5866000,56403.846153846156,57,2002000,35122.80701754386,47,3864000
2020,county,48113,Dallas,26081,Kent,MI,Rural Michigan,107,3111000,29074.766355140186,57,2606000,45719.29824561404,50,505000
2020,county,48439,Tarrant,06029,Kern,CA,Rural California,146,3598000,24643.835616438355,52,1555000,29903.846153846152,94,2043000
2020,county,48113,Dallas,06029,Kern,CA,Rural California,96,1990000,20729.166666666668,61,992000,16262.295081967213,35,998000
2020,county,48439,Tarrant,48265,Kerr,TX,Rural Texas,45,1500000,33333.333333333336,48,2583000,53812.5,-3,-1083000
2020,county,48439,Tarrant,53033,King,WA,Seattle,337,21395000,63486.646884272996,342,15763000,46090.6432748538,-5,5632000
2020,county,48113,Dallas,53033,King,WA,Seattle,512,34754000,67878.90625,627,50802000,81023.92344497607,-115,-16048000
2020,county,48121,Denton,53033,King,WA,Seattle,306,22768000,74405.22875816993,238,15311000,64331.93277310924,68,7457000
2020,county,48085,Collin,53033,King,WA,Seattle,643,41798000,65004.66562986003,526,31644000,60159.695817490494,117,10154000
2020,county,48439,Tarrant,36047,Kings,NY,New York,217,8606000,39658.986175115206,107,3951000,36925.233644859814,110,4655000
2020,county,48113,Dallas,36047,Kings,NY,New York,413,23741000,57484.261501210654,167,10918000,65377.245508982036,246,12823000
2020,county,48121,Denton,36047,Kings,NY,New York,110,5075000,46136.36363636364,33,1381000,41848.48484848485,77,3694000
2020,county,48085,Collin,36047,Kings,NY,New York,259,11254000,43451.73745173745,59,1978000,33525.42372881356,200,9276000
2020,county,48439,Tarrant,53035,Kitsap,WA,Rural Washington,43,1534000,35674.41860465116,31,1127000,36354.83870967742,12,407000
2020,county,48113,Dallas,53035,Kitsap,WA,Rural Washington,45,1698000,37733.333333333336,31,1910000,61612.903225806454,14,-212000
2020,county,48439,Tarrant,47093,Knox,TN,Knoxville,77,2439000,31675.324675324675,95,2892000,30442.105263157893,-18,-453000
2020,county,48113,Dallas,47093,Knox,TN,Knoxville,38,1505000,39605.26315789474,45,1989000,44200.0,-7,-484000
2020,county,48439,Tarrant,22055,Lafayette Parish,LA,Rural Louisiana,85,2117000,24905.882352941175,55,1575000,28636.363636363636,30,542000
2020,county,48113,Dallas,22055,Lafayette Parish,LA,Rural Louisiana,98,2542000,25938.775510204083,64,1676000,26187.5,34,866000
2020,county,48439,Tarrant,17097,Lake,IL,Chicago,124,10235000,82540.32258064517,76,2414000,31763.157894736843,48,7821000
2020,county,48439,Tarrant,18089,Lake,IN,Rural Indiana,101,1745000,17277.227722772277,40,644000,16100.0,61,1101000
2020,county,48113,Dallas,17097,Lake,IL,Chicago,101,9383000,92900.9900990099,54,3071000,56870.37037037037,47,6312000
2020,county,48085,Collin,17097,Lake,IL,Chicago,168,8814000,52464.28571428572,55,2921000,53109.09090909091,113,5893000
2020,county,48439,Tarrant,48277,Lamar,TX,Rural Texas,69,1765000,25579.710144927536,110,3615000,32863.63636363636,-41,-1850000
2020,county,48113,Dallas,48277,Lamar,TX,Rural Texas,128,2261000,17664.0625,190,3772000,19852.63157894737,-62,-1511000
2020,county,48121,Denton,48277,Lamar,TX,Rural Texas,28,618000,22071.428571428572,72,3134000,43527.77777777778,-44,-2516000
2020,county,48085,Collin,48277,Lamar,TX,Rural Texas,73,2036000,27890.41095890411,106,2986000,28169.811320754718,-33,-950000
2020,county,48113,Dallas,31109,Lancaster,NE,Rural Nebraska,49,1332000,27183.673469387755,46,748000,16260.869565217392,3,584000
2020,county,48439,Tarrant,08069,Larimer,CO,Rural Colorado,81,3368000,41580.246913580246,101,8025000,79455.44554455446,-20,-4657000
2020,county,48113,Dallas,08069,Larimer,CO,Rural Colorado,51,2510000,49215.686274509804,92,4408000,47913.04347826087,-41,-1898000
2020,county,48121,Denton,08069,Larimer,CO,Rural Colorado,69,3615000,52391.30434782609,55,2505000,45545.454545454544,14,1110000
2020,county,48085,Collin,08069,Larimer,CO,Rural Colorado,45,1368000,30400.0,64,4288000,67000.0,-19,-2920000
2020,county,48113,Dallas,35025,Lea,NM,Rural New Mexico,30,786000,26200.0,37,716000,19351.35135135135,-7,70000
2020,county,48439,Tarrant,12071,Lee,FL,S.W. Florida,90,4362000,48466.666666666664,104,5708000,54884.61538461538,-14,-1346000
2020,county,48113,Dallas,12071,Lee,FL,S.W. Florida,88,4375000,49715.90909090909,105,4094000,38990.47619047619,-17,281000
2020,county,48121,Denton,12071,Lee,FL,S.W. Florida,53,3017000,56924.52830188679,97,4393000,45288.65979381443,-44,-1376000
2020,county,48085,Collin,12071,Lee,FL,S.W. Florida,67,2423000,36164.17910447761,74,4959000,67013.51351351352,-7,-2536000
2020,county,48113,Dallas,48293,Limestone,TX,Rural Texas,56,989000,17660.714285714286,47,853000,18148.936170212764,9,136000
2020,county,48113,Dallas,22061,Lincoln Parish,LA,Rural Louisiana,109,1721000,15788.990825688074,51,1215000,23823.529411764706,58,506000
2020,county,48439,Tarrant,06037,Los Angeles,CA,Los Angeles,1556,63116000,40562.98200514139,691,28798000,41675.83212735166,865,34318000
2020,county,48113,Dallas,06037,Los Angeles,CA,Los Angeles,1878,121321000,64601.171458998935,992,50116000,50520.16129032258,886,71205000
2020,county,48121,Denton,06037,Los Angeles,CA,Los Angeles,1002,44502000,44413.17365269461,315,15697000,49831.74603174603,687,28805000
2020,county,48085,Collin,06037,Los Angeles,CA,Los Angeles,1473,68107000,46236.93143245078,472,24479000,51862.28813559322,1001,43628000
2020,county,48113,Dallas,51107,Loudoun,VA,Rural Virginia,95,6301000,66326.31578947368,68,4228000,62176.470588235294,27,2073000
2020,county,48085,Collin,51107,Loudoun,VA,Rural Virginia,142,10735000,75598.59154929577,73,2999000,41082.191780821915,69,7736000
2020,county,48439,Tarrant,48303,Lubbock,TX,Rural Texas,629,16401000,26074.721780604134,440,12197000,27720.454545454544,189,4204000
2020,county,48113,Dallas,48303,Lubbock,TX,Rural Texas,441,12592000,28553.287981859412,362,11324000,31281.767955801104,79,1268000
2020,county,48121,Denton,48303,Lubbock,TX,Rural Texas,287,8843000,30811.846689895472,216,7874000,36453.7037037037,71,969000
2020,county,48085,Collin,48303,Lubbock,TX,Rural Texas,277,10317000,37245.48736462094,201,7707000,38343.28358208955,76,2610000
2020,county,48439,Tarrant,01089,Madison,AL,Huntsville,51,2354000,46156.86274509804,130,3676000,28276.923076923078,-79,-1322000
2020,county,48113,Dallas,01089,Madison,AL,Huntsville,90,3874000,43044.444444444445,69,2666000,38637.68115942029,21,1208000
2020,county,48113,Dallas,28089,Madison,MS,Jackson,85,3125000,36764.705882352944,35,1175000,33571.42857142857,50,1950000
2020,county,48085,Collin,01089,Madison,AL,Huntsville,50,1959000,39180.0,52,2850000,54807.692307692305,-2,-891000
2020,county,48439,Tarrant,12081,Manatee,FL,Rural Florida,40,746000,18650.0,63,3943000,62587.30158730159,-23,-3197000
2020,county,48439,Tarrant,04013,Maricopa,AZ,Phoenix,852,33194000,38960.09389671362,802,41386000,51603.49127182045,50,-8192000
2020,county,48113,Dallas,04013,Maricopa,AZ,Phoenix,900,60103000,66781.11111111111,828,126619000,152921.49758454107,72,-66516000
2020,county,48121,Denton,04013,Maricopa,AZ,Phoenix,613,39654000,64688.417618270796,413,17883000,43300.24213075061,200,21771000
2020,county,48085,Collin,04013,Maricopa,AZ,Phoenix,699,30364000,43439.19885550787,521,32338000,62069.09788867562,178,-1974000
2020,county,48439,Tarrant,18097,Marion,IN,Indianapolis,155,3987000,25722.58064516129,130,4466000,34353.846153846156,25,-479000
2020,county,48113,Dallas,18097,Marion,IN,Indianapolis,225,9247000,41097.77777777778,116,3996000,34448.275862068964,109,5251000
2020,county,48121,Denton,18097,Marion,IN,Indianapolis,72,2011000,27930.555555555555,91,2002000,22000.0,-19,9000
2020,county,48085,Collin,18097,Marion,IN,Indianapolis,118,4825000,40889.83050847457,50,2212000,44240.0,68,2613000
2020,county,48085,Collin,17113,McLean,IL,Rural Illinois,237,14027000,59185.65400843882,55,3047000,55400.0,182,10980000
2020,county,48439,Tarrant,48309,McLennan,TX,Rural Texas,560,14602000,26075.0,519,11502000,22161.84971098266,41,3100000
2020,county,48113,Dallas,48309,McLennan,TX,Rural Texas,522,11235000,21522.988505747126,496,13064000,26338.709677419356,26,-1829000
2020,county,48121,Denton,48309,McLennan,TX,Rural Texas,214,5581000,26079.439252336448,174,5044000,28988.505747126437,40,537000
2020,county,48085,Collin,48309,McLennan,TX,Rural Texas,151,4588000,30384.1059602649,140,5231000,37364.28571428572,11,-643000
2020,county,48439,Tarrant,37119,Mecklenburg,NC,Charlotte,150,6214000,41426.666666666664,144,7334000,50930.555555555555,6,-1120000
2020,county,48113,Dallas,37119,Mecklenburg,NC,Charlotte,330,15190000,46030.30303030303,274,15404000,56218.97810218978,56,-214000
2020,county,48121,Denton,37119,Mecklenburg,NC,Charlotte,104,5601000,53855.769230769234,102,7675000,75245.09803921569,2,-2074000
2020,county,48085,Collin,37119,Mecklenburg,NC,Charlotte,211,11505000,54526.0663507109,153,9077000,59326.797385620914,58,2428000
2020,county,48439,Tarrant,12086,Miami-Dade,FL,Miami,391,10264000,26250.639386189257,190,6130000,32263.157894736843,201,4134000
2020,county,48113,Dallas,12086,Miami-Dade,FL,Miami,491,22830000,46496.9450101833,345,14637000,42426.086956521736,146,8193000
2020,county,48121,Denton,12086,Miami-Dade,FL,Miami,190,6634000,34915.78947368421,75,1736000,23146.666666666668,115,4898000
2020,county,48085,Collin,12086,Miami-Dade,FL,Miami,227,5585000,24603.52422907489,106,4258000,40169.811320754714,121,1327000
2020,county,48439,Tarrant,25017,Middlesex,MA,Boston,129,6062000,46992.248062015504,84,3688000,43904.76190476191,45,2374000
2020,county,48439,Tarrant,34023,Middlesex,NJ,New York,53,2502000,47207.54716981132,30,784000,26133.333333333332,23,1718000
2020,county,48113,Dallas,25017,Middlesex,MA,Boston,229,22826000,99676.85589519651,181,11312000,62497.23756906077,48,11514000
2020,county,48113,Dallas,34023,Middlesex,NJ,New York,235,8905000,37893.617021276594,120,5199000,43325.0,115,3706000
2020,county,48121,Denton,25017,Middlesex,MA,Boston,123,8798000,71528.45528455285,59,2807000,47576.27118644068,64,5991000
2020,county,48085,Collin,34023,Middlesex,NJ,New York,377,17493000,46400.53050397878,60,2359000,39316.666666666664,317,15134000
2020,county,48085,Collin,25017,Middlesex,MA,Boston,189,8692000,45989.41798941799,100,6629000,66290.0,89,2063000
2020,county,48439,Tarrant,48329,Midland,TX,Rural Texas,496,23432000,47241.93548387097,267,9656000,36164.79400749064,229,13776000
2020,county,48113,Dallas,48329,Midland,TX,Rural Texas,378,33050000,87433.86243386244,217,7216000,33253.456221198154,161,25834000
2020,county,48121,Denton,48329,Midland,TX,Rural Texas,185,9095000,49162.16216216216,81,3844000,47456.79012345679,104,5251000
2020,county,48085,Collin,48329,Midland,TX,Rural Texas,145,7620000,52551.724137931036,78,2374000,30435.897435897437,67,5246000
2020,county,48113,Dallas,05091,Miller,AR,Rural Arkansas,35,595000,17000.0,38,529000,13921.052631578947,-3,66000
2020,county,48439,Tarrant,55079,Milwaukee,WI,Milwaukee,259,5429000,20961.389961389963,110,2050000,18636.363636363636,149,3379000
2020,county,48113,Dallas,55079,Milwaukee,WI,Milwaukee,233,12456000,53459.22746781116,116,3631000,31301.724137931036,117,8825000
2020,county,48085,Collin,55079,Milwaukee,WI,Milwaukee,135,3381000,25044.444444444445,39,1132000,29025.641025641027,96,2249000
2020,county,48113,Dallas,01097,Mobile,AL,Mobile,84,2114000,25166.666666666668,53,1329000,25075.471698113208,31,785000
2020,county,48113,Dallas,36055,Monroe,NY,Rochester,87,3261000,37482.75862068965,47,1907000,40574.46808510638,40,1354000
2020,county,48439,Tarrant,48337,Montague,TX,Rural Texas,102,2537000,24872.549019607843,229,7724000,33729.257641921395,-127,-5187000
2020,county,48113,Dallas,48337,Montague,TX,Rural Texas,38,1923000,50605.26315789474,47,1518000,32297.872340425532,-9,405000
2020,county,48121,Denton,48337,Montague,TX,Rural Texas,75,1727000,23026.666666666668,231,8467000,36653.679653679654,-156,-6740000
2020,county,48113,Dallas,06053,Monterey,CA,Rural California,38,1315000,34605.26315789474,39,3788000,97128.20512820513,-1,-2473000
2020,county,48439,Tarrant,48339,Montgomery,TX,Houston,396,24316000,61404.0404040404,711,36946000,51963.4317862166,-315,-12630000
2020,county,48439,Tarrant,24031,Montgomery,MD,D.C.,98,4757000,48540.816326530614,66,2120000,32121.21212121212,32,2637000
2020,county,48439,Tarrant,39113,Montgomery,OH,Rural Ohio,68,1690000,24852.941176470587,83,2350000,28313.253012048193,-15,-660000
2020,county,48439,Tarrant,47125,Montgomery,TN,Rural Tennessee,78,1564000,20051.28205128205,66,1171000,17742.424242424244,12,393000
2020,county,48113,Dallas,48339,Montgomery,TX,Houston,332,17967000,54117.469879518074,394,23447000,59510.15228426396,-62,-5480000
2020,county,48113,Dallas,24031,Montgomery,MD,D.C.,147,6657000,45285.71428571428,154,9402000,61051.94805194805,-7,-2745000
2020,county,48113,Dallas,42091,Montgomery,PA,Philadelphia,85,4661000,54835.294117647056,69,5543000,80333.33333333333,16,-882000
2020,county,48113,Dallas,39113,Montgomery,OH,Rural Ohio,44,1356000,30818.18181818182,52,1699000,32673.076923076922,-8,-343000
2020,county,48121,Denton,48339,Montgomery,TX,Houston,310,19127000,61700.0,244,12351000,50618.852459016394,66,6776000
2020,county,48085,Collin,48339,Montgomery,TX,Houston,268,15415000,57518.65671641791,282,22412000,79475.17730496454,-14,-6997000
2020,county,48085,Collin,24031,Montgomery,MD,D.C.,132,5876000,44515.15151515151,84,2448000,29142.85714285714,48,3428000
2020,county,48113,Dallas,34027,Morris,NJ,New York,55,6017000,109400.0,51,3904000,76549.01960784313,4,2113000
2020,county,48439,Tarrant,41051,Multnomah,OR,Portland,90,5060000,56222.22222222222,73,2593000,35520.54794520548,17,2467000
2020,county,48113,Dallas,41051,Multnomah,OR,Portland,118,6352000,53830.50847457627,118,8528000,72271.18644067796,0,-2176000
2020,county,48121,Denton,41051,Multnomah,OR,Portland,44,2728000,62000.0,35,1369000,39114.28571428572,9,1359000
2020,county,48085,Collin,41051,Multnomah,OR,Portland,44,2395000,54431.818181818184,62,2656000,42838.709677419356,-18,-261000
2020,county,48439,Tarrant,48347,Nacogdoches,TX,Rural Texas,69,1951000,28275.36231884058,73,1757000,24068.49315068493,-4,194000
2020,county,48113,Dallas,48347,Nacogdoches,TX,Rural Texas,82,2166000,26414.634146341465,65,1711000,26323.076923076922,17,455000
2020,county,48121,Denton,48347,Nacogdoches,TX,Rural Texas,41,1491000,36365.85365853659,41,1039000,25341.463414634145,0,452000
2020,county,48113,Dallas,36059,Nassau,NY,New York,140,8971000,64078.57142857143,51,15981000,313352.9411764706,89,-7010000
2020,county,48439,Tarrant,48349,Navarro,TX,Rural Texas,184,3327000,18081.521739130436,214,6756000,31570.093457943924,-30,-3429000
2020,county,48113,Dallas,48349,Navarro,TX,Rural Texas,323,5907000,18287.925696594426,667,13634000,20440.779610194902,-344,-7727000
2020,county,48121,Denton,48349,Navarro,TX,Rural Texas,50,1313000,26260.0,78,3197000,40987.179487179485,-28,-1884000
2020,county,48439,Tarrant,10003,New Castle,DE,Rural Delaware,53,2308000,43547.16981132075,42,3281000,78119.04761904762,11,-973000
2020,county,48113,Dallas,10003,New Castle,DE,Rural Delaware,90,3978000,44200.0,48,3588000,74750.0,42,390000
2020,county,48113,Dallas,09009,New Haven,CT,New Haven,58,2753000,47465.51724137931,46,2570000,55869.565217391304,12,183000
2020,county,48439,Tarrant,36061,New York,NY,New York,168,23077000,137363.09523809524,94,6954000,73978.72340425532,74,16123000
2020,county,48113,Dallas,36061,New York,NY,New York,634,92787000,146351.73501577287,347,51101000,147265.12968299713,287,41686000
2020,county,48121,Denton,36061,New York,NY,New York,109,10135000,92981.6513761468,43,7179000,166953.48837209304,66,2956000
2020,county,48085,Collin,36061,New York,NY,New York,217,19449000,89626.72811059908,117,8034000,68666.66666666667,100,11415000
2020,county,48113,Dallas,25021,Norfolk,MA,Boston,109,7001000,64229.35779816514,58,5682000,97965.5172413793,51,1319000
2020,county,48085,Collin,25021,Norfolk,MA,Boston,105,3803000,36219.04761904762,42,1572000,37428.57142857143,63,2231000
2020,county,48439,Tarrant,51710,Norfolk city,VA,Hampton Roads,61,1547000,25360.655737704918,67,1338000,19970.149253731342,-6,209000
2020,county,48113,Dallas,51710,Norfolk city,VA,Hampton Roads,42,1093000,26023.809523809523,48,1387000,28895.833333333332,-6,-294000
2020,county,48439,Tarrant,48355,Nueces,TX,Rural Texas,251,7012000,27936.25498007968,245,6925000,28265.30612244898,6,87000
2020,county,48113,Dallas,48355,Nueces,TX,Rural Texas,188,5821000,30962.76595744681,153,5379000,35156.86274509804,35,442000
2020,county,48121,Denton,48355,Nueces,TX,Rural Texas,125,3784000,30272.0,108,3157000,29231.48148148148,17,627000
2020,county,48085,Collin,48355,Nueces,TX,Rural Texas,112,3822000,34125.0,93,4349000,46763.44086021505,19,-527000
2020,county,48439,Tarrant,26125,Oakland,MI,Detroit,155,6172000,39819.354838709674,119,6969000,58563.02521008404,36,-797000
2020,county,48113,Dallas,26125,Oakland,MI,Detroit,226,14719000,65128.318584070796,99,5888000,59474.74747474748,127,8831000
2020,county,48121,Denton,26125,Oakland,MI,Detroit,195,11110000,56974.35897435898,54,3822000,70777.77777777778,141,7288000
2020,county,48085,Collin,26125,Oakland,MI,Detroit,210,6182000,29438.095238095237,88,4920000,55909.09090909091,122,1262000
2020,county,48439,Tarrant,12091,Okaloosa,FL,FL Panhandle,59,2290000,38813.5593220339,81,2809000,34679.01234567901,-22,-519000
2020,county,48113,Dallas,12091,Okaloosa,FL,FL Panhandle,39,1509000,38692.307692307695,51,1077000,21117.647058823528,-12,432000
2020,county,48439,Tarrant,40109,Oklahoma,OK,Oklahoma City,522,15753000,30178.16091954023,517,15069000,29147.001934235977,5,684000
2020,county,48113,Dallas,40109,Oklahoma,OK,Oklahoma City,558,22202000,39788.53046594982,593,18837000,31765.598650927488,-35,3365000
2020,county,48121,Denton,40109,Oklahoma,OK,Oklahoma City,344,15029000,43688.95348837209,248,9309000,37536.290322580644,96,5720000
2020,county,48085,Collin,40109,Oklahoma,OK,Oklahoma City,354,13757000,38861.581920903955,233,7515000,32253.21888412017,121,6242000
2020,county,48113,Dallas,36067,Onondaga,NY,Rural New York,28,1546000,55214.28571428572,29,912000,31448.275862068964,-1,634000
2020,county,48439,Tarrant,37133,Onslow,NC,Rural North Carolina,128,2516000,19656.25,85,1287000,15141.176470588236,43,1229000
2020,county,48113,Dallas,37133,Onslow,NC,Rural North Carolina,58,973000,16775.862068965518,53,1328000,25056.603773584906,5,-355000
2020,county,48439,Tarrant,06059,Orange,CA,Los Angeles,660,32954000,49930.30303030303,279,15788000,56587.81362007168,381,17166000
2020,county,48439,Tarrant,12095,Orange,FL,Orlando,301,11148000,37036.544850498336,277,13369000,48263.537906137186,24,-2221000
2020,county,48113,Dallas,06059,Orange,CA,Los Angeles,700,50256000,71794.28571428571,426,24665000,57899.06103286385,274,25591000
2020,county,48113,Dallas,12095,Orange,FL,Orlando,322,11175000,34704.96894409938,219,9943000,45401.82648401827,103,1232000
2020,county,48121,Denton,06059,Orange,CA,Los Angeles,697,39837000,57154.94978479196,178,11223000,63050.56179775281,519,28614000
2020,county,48121,Denton,12095,Orange,FL,Orlando,183,6760000,36939.89071038251,112,4950000,44196.42857142857,71,1810000
2020,county,48085,Collin,06059,Orange,CA,Los Angeles,906,66399000,73288.07947019867,226,13651000,60402.654867256635,680,52748000
2020,county,48085,Collin,12095,Orange,FL,Orlando,212,6025000,28419.811320754718,171,8777000,51327.48538011696,41,-2752000
2020,county,48439,Tarrant,22071,Orleans Parish,LA,New Orleans,173,3094000,17884.393063583815,98,2185000,22295.918367346938,75,909000
2020,county,48113,Dallas,22071,Orleans Parish,LA,New Orleans,220,5803000,26377.272727272728,175,5514000,31508.571428571428,45,289000
2020,county,48121,Denton,22071,Orleans Parish,LA,New Orleans,72,1375000,19097.222222222223,40,1020000,25500.0,32,355000
2020,county,48439,Tarrant,12097,Osceola,FL,Orlando,80,1391000,17387.5,74,2481000,33527.02702702703,6,-1090000
2020,county,48113,Dallas,12097,Osceola,FL,Orlando,41,1657000,40414.634146341465,48,1806000,37625.0,-7,-149000
2020,county,48439,Tarrant,22073,Ouachita Parish,LA,Rural Louisiana,310,4606000,14858.064516129032,103,989000,9601.941747572815,207,3617000
2020,county,48113,Dallas,22073,Ouachita Parish,LA,Rural Louisiana,342,4050000,11842.105263157895,130,2442000,18784.615384615383,212,1608000
2020,county,48085,Collin,22073,Ouachita Parish,LA,Rural Louisiana,113,2956000,26159.29203539823,43,957000,22255.81395348837,70,1999000
2020,county,48439,Tarrant,12099,Palm Beach,FL,Miami,158,9550000,60443.037974683546,150,6807000,45380.0,8,2743000
2020,county,48113,Dallas,12099,Palm Beach,FL,Miami,205,14561000,71029.26829268293,188,12300000,65425.53191489362,17,2261000
2020,county,48121,Denton,12099,Palm Beach,FL,Miami,143,7454000,52125.87412587413,75,4238000,56506.666666666664,68,3216000
2020,county,48085,Collin,12099,Palm Beach,FL,Miami,138,5761000,41746.3768115942,94,4385000,46648.936170212764,44,1376000
2020,county,48439,Tarrant,48363,Palo Pinto,TX,Rural Texas,170,4877000,28688.235294117647,267,8592000,32179.775280898877,-97,-3715000
2020,county,48121,Denton,48363,Palo Pinto,TX,Rural Texas,54,1433000,26537.037037037036,38,1894000,49842.10526315789,16,-461000
2020,county,48439,Tarrant,48367,Parker,TX,Dallas-Fort Worth,3308,116385000,35182.8899637243,7071,257100000,36359.77938056852,-3763,-140715000
2020,county,48113,Dallas,48367,Parker,TX,Dallas-Fort Worth,166,5402000,32542.168674698794,380,10996000,28936.842105263157,-214,-5594000
2020,county,48121,Denton,48367,Parker,TX,Dallas-Fort Worth,295,10339000,35047.457627118645,399,18134000,45448.62155388471,-104,-7795000
2020,county,48085,Collin,48367,Parker,TX,Dallas-Fort Worth,59,2237000,37915.254237288136,192,8126000,42322.916666666664,-133,-5889000
2020,county,48439,Tarrant,12101,Pasco,FL,Tampa,66,2094000,31727.272727272728,66,2662000,40333.333333333336,0,-568000
2020,county,48113,Dallas,12101,Pasco,FL,Tampa,46,761000,16543.478260869564,69,2275000,32971.014492753624,-23,-1514000
2020,county,48121,Denton,12101,Pasco,FL,Tampa,36,1487000,41305.555555555555,65,2168000,33353.846153846156,-29,-681000
2020,county,48113,Dallas,40119,Payne,OK,Rural Oklahoma,50,1641000,32820.0,31,1105000,35645.16129032258,19,536000
2020,county,48113,Dallas,17143,Peoria,IL,Rural Illinois,62,1566000,25258.064516129034,35,695000,19857.14285714286,27,871000
2020,county,48439,Tarrant,42101,Philadelphia,PA,Philadelphia,92,2477000,26923.91304347826,45,1778000,39511.11111111111,47,699000
2020,county,48113,Dallas,42101,Philadelphia,PA,Philadelphia,213,12078000,56704.22535211268,126,8614000,68365.07936507936,87,3464000
2020,county,48121,Denton,42101,Philadelphia,PA,Philadelphia,49,2189000,44673.4693877551,38,1200000,31578.947368421053,11,989000
2020,county,48085,Collin,42101,Philadelphia,PA,Philadelphia,71,3522000,49605.633802816905,29,1559000,53758.620689655174,42,1963000
2020,county,48439,Tarrant,53053,Pierce,WA,Seattle,240,5993000,24970.833333333332,133,3840000,28872.18045112782,107,2153000
2020,county,48113,Dallas,53053,Pierce,WA,Seattle,117,3750000,32051.28205128205,94,3368000,35829.78723404255,23,382000
2020,county,48121,Denton,53053,Pierce,WA,Seattle,92,2580000,28043.478260869564,63,3145000,49920.63492063492,29,-565000
2020,county,48085,Collin,53053,Pierce,WA,Seattle,119,3892000,32705.882352941175,73,2473000,33876.71232876712,46,1419000
2020,county,48439,Tarrant,04019,Pima,AZ,Tucson,202,7964000,39425.74257425743,153,5608000,36653.59477124183,49,2356000
2020,county,48113,Dallas,04019,Pima,AZ,Tucson,161,9586000,59540.372670807454,152,7568000,49789.47368421053,9,2018000
2020,county,48121,Denton,04019,Pima,AZ,Tucson,90,3044000,33822.22222222222,93,4001000,43021.50537634409,-3,-957000
2020,county,48085,Collin,04019,Pima,AZ,Tucson,195,8542000,43805.1282051282,69,3688000,53449.27536231884,126,4854000
2020,county,48439,Tarrant,04021,Pinal,AZ,Phoenix,41,1047000,25536.585365853658,47,2099000,44659.574468085106,-6,-1052000
2020,county,48439,Tarrant,12103,Pinellas,FL,Tampa,104,3465000,33317.307692307695,132,6259000,47416.666666666664,-28,-2794000
2020,county,48113,Dallas,12103,Pinellas,FL,Tampa,105,4480000,42666.666666666664,148,12264000,82864.86486486487,-43,-7784000
2020,county,48121,Denton,12103,Pinellas,FL,Tampa,89,2571000,28887.6404494382,84,3898000,46404.76190476191,5,-1327000
2020,county,48085,Collin,12103,Pinellas,FL,Tampa,79,3393000,42949.36708860759,96,6133000,63885.416666666664,-17,-2740000
2020,county,48439,Tarrant,12105,Polk,FL,Orlando,76,2635000,34671.05263157895,121,2572000,21256.198347107438,-45,63000
2020,county,48439,Tarrant,19153,Polk,IA,Rural Iowa,61,1887000,30934.426229508197,61,1571000,25754.09836065574,0,316000
2020,county,48439,Tarrant,48373,Polk,TX,Rural Texas,37,1313000,35486.48648648649,97,5134000,52927.83505154639,-60,-3821000
2020,county,48113,Dallas,19153,Polk,IA,Rural Iowa,102,4386000,43000.0,66,7516000,113878.78787878787,36,-3130000
2020,county,48113,Dallas,12105,Polk,FL,Orlando,63,1818000,28857.14285714286,108,2956000,27370.37037037037,-45,-1138000
2020,county,48121,Denton,12105,Polk,FL,Orlando,45,1902000,42266.666666666664,48,1769000,36854.166666666664,-3,133000
2020,county,48439,Tarrant,48375,Potter,TX,Rural Texas,152,3552000,23368.42105263158,107,2619000,24476.635514018693,45,933000
2020,county,48113,Dallas,48375,Potter,TX,Rural Texas,117,2982000,25487.17948717949,97,1524000,15711.340206185567,20,1458000
2020,county,48121,Denton,48375,Potter,TX,Rural Texas,59,1017000,17237.28813559322,59,1204000,20406.77966101695,0,-187000
2020,county,48439,Tarrant,24033,Prince George,MD,Rural Maryland,78,2221000,28474.358974358973,63,2031000,32238.095238095237,15,190000
2020,county,48113,Dallas,24033,Prince George,MD,Rural Maryland,118,3788000,32101.694915254237,81,3574000,44123.456790123455,37,214000
2020,county,48085,Collin,24033,Prince George,MD,Rural Maryland,59,2080000,35254.23728813559,60,1669000,27816.666666666668,-1,411000
2020,county,48439,Tarrant,51153,Prince William,VA,Rural Virginia,125,3868000,30944.0,69,2453000,35550.72463768116,56,1415000
2020,county,48113,Dallas,51153,Prince William,VA,Rural Virginia,53,1449000,27339.622641509435,48,1236000,25750.0,5,213000
2020,county,48439,Tarrant,05119,Pulaski,AR,Little Rock,285,7725000,27105.263157894737,189,5705000,30185.185185185186,96,2020000
2020,county,48113,Dallas,05119,Pulaski,AR,Little Rock,416,12178000,29274.03846153846,278,9745000,35053.95683453237,138,2433000
2020,county,48121,Denton,05119,Pulaski,AR,Little Rock,136,4720000,34705.882352941175,90,3030000,33666.666666666664,46,1690000
2020,county,48085,Collin,05119,Pulaski,AR,Little Rock,159,5469000,34396.22641509434,80,2788000,34850.0,79,2681000
2020,county,48439,Tarrant,36081,Queens,NY,New York,253,7411000,29292.490118577076,62,1101000,17758.064516129034,191,6310000
2020,county,48113,Dallas,36081,Queens,NY,New York,300,10595000,35316.666666666664,94,4499000,47861.70212765958,206,6096000
2020,county,48121,Denton,36081,Queens,NY,New York,127,5291000,41661.41732283465,41,1097000,26756.09756097561,86,4194000
2020,county,48085,Collin,36081,Queens,NY,New York,273,8647000,31673.992673992674,64,1966000,30718.75,209,6681000
2020,county,48113,Dallas,48379,Rains,TX,Rural Texas,42,1086000,25857.14285714286,106,3690000,34811.32075471698,-64,-2604000
2020,county,48113,Dallas,27123,Ramsey,MN,Minneapolis,107,2739000,25598.130841121496,48,1583000,32979.166666666664,59,1156000
2020,county,48439,Tarrant,48381,Randall,TX,Rural Texas,227,8633000,38030.837004405286,195,6316000,32389.74358974359,32,2317000
2020,county,48113,Dallas,48381,Randall,TX,Rural Texas,117,3141000,26846.153846153848,122,4742000,38868.852459016394,-5,-1601000
2020,county,48121,Denton,48381,Randall,TX,Rural Texas,113,4076000,36070.79646017699,78,2626000,33666.666666666664,35,1450000
2020,county,48085,Collin,48381,Randall,TX,Rural Texas,113,3931000,34787.61061946903,57,3494000,61298.245614035084,56,437000
2020,county,48439,Tarrant,45079,Richland,SC,Columbia,67,2815000,42014.92537313433,40,977000,24425.0,27,1838000
2020,county,48113,Dallas,45079,Richland,SC,Columbia,54,1626000,30111.11111111111,35,1234000,35257.142857142855,19,392000
2020,county,48439,Tarrant,06065,Riverside,CA,San Bernardino-Riverside,479,13401000,27977.035490605427,277,7474000,26981.949458483756,202,5927000
2020,county,48113,Dallas,06065,Riverside,CA,San Bernardino-Riverside,330,9700000,29393.939393939392,189,7171000,37941.798941798945,141,2529000
2020,county,48121,Denton,06065,Riverside,CA,San Bernardino-Riverside,352,14443000,41031.25,89,3779000,42460.67415730337,263,10664000
2020,county,48085,Collin,06065,Riverside,CA,San Bernardino-Riverside,477,16853000,35331.23689727463,87,3415000,39252.87356321839,390,13438000
2020,county,48439,Tarrant,48397,Rockwall,TX,Dallas-Fort Worth,273,8995000,32948.717948717946,362,14265000,39406.0773480663,-89,-5270000
2020,county,48113,Dallas,48397,Rockwall,TX,Dallas-Fort Worth,1842,67880000,36851.24864277959,4939,176336000,35702.77384085847,-3097,-108456000
2020,county,48121,Denton,48397,Rockwall,TX,Dallas-Fort Worth,316,12472000,39468.354430379746,343,13424000,39137.026239067054,-27,-952000
2020,county,48085,Collin,48397,Rockwall,TX,Dallas-Fort Worth,1048,34368000,32793.89312977099,1515,56971000,37604.6204620462,-467,-22603000
2020,county,48439,Tarrant,48401,Rusk,TX,Rural Texas,57,782000,13719.298245614034,64,2038000,31843.75,-7,-1256000
2020,county,48113,Dallas,48401,Rusk,TX,Rural Texas,58,916000,15793.103448275862,92,1915000,20815.217391304348,-34,-999000
2020,county,48439,Tarrant,47149,Rutherford,TN,Nashville,45,1343000,29844.444444444445,46,1711000,37195.65217391304,-1,-368000
2020,county,48439,Tarrant,06067,Sacramento,CA,Sacramento,226,6587000,29146.017699115044,150,3320000,22133.333333333332,76,3267000
2020,county,48113,Dallas,06067,Sacramento,CA,Sacramento,203,12575000,61945.812807881775,170,5067000,29805.882352941175,33,7508000
2020,county,48121,Denton,06067,Sacramento,CA,Sacramento,107,4754000,44429.90654205607,36,1136000,31555.555555555555,71,3618000
2020,county,48085,Collin,06067,Sacramento,CA,Sacramento,158,7150000,45253.16455696202,57,3373000,59175.43859649123,101,3777000
2020,county,48439,Tarrant,05125,Saline,AR,Little Rock,66,1439000,21803.030303030304,66,2940000,44545.454545454544,0,-1501000
2020,county,48113,Dallas,05125,Saline,AR,Little Rock,53,1112000,20981.132075471698,35,1843000,52657.142857142855,18,-731000
2020,county,48439,Tarrant,49035,Salt Lake,UT,Salt Lake,219,8009000,36570.776255707766,183,7010000,38306.01092896175,36,999000
2020,county,48113,Dallas,49035,Salt Lake,UT,Salt Lake,189,8441000,44661.37566137566,159,10309000,64836.477987421385,30,-1868000
2020,county,48121,Denton,49035,Salt Lake,UT,Salt Lake,135,5142000,38088.88888888889,100,4536000,45360.0,35,606000
2020,county,48085,Collin,49035,Salt Lake,UT,Salt Lake,206,6758000,32805.82524271845,137,5618000,41007.299270072996,69,1140000
2020,county,48439,Tarrant,06071,San Bernardino,CA,San Bernardino-Riverside,454,9838000,21669.603524229075,202,4498000,22267.326732673268,252,5340000
2020,county,48113,Dallas,06071,San Bernardino,CA,San Bernardino-Riverside,269,7697000,28613.382899628254,165,4129000,25024.242424242424,104,3568000
2020,county,48121,Denton,06071,San Bernardino,CA,San Bernardino-Riverside,235,8078000,34374.46808510638,93,2943000,31645.16129032258,142,5135000
2020,county,48085,Collin,06071,San Bernardino,CA,San Bernardino-Riverside,326,11536000,35386.503067484664,62,2215000,35725.8064516129,264,9321000
2020,county,48439,Tarrant,06073,San Diego,CA,San Diego,1060,34328000,32384.905660377357,451,13369000,29643.015521064302,609,20959000
2020,county,48113,Dallas,06073,San Diego,CA,San Diego,704,27735000,39396.306818181816,538,29283000,54429.36802973978,166,-1548000
2020,county,48121,Denton,06073,San Diego,CA,San Diego,529,20885000,39480.15122873346,142,7623000,53683.09859154929,387,13262000
2020,county,48085,Collin,06073,San Diego,CA,San Diego,638,26047000,40826.01880877743,242,13548000,55983.47107438016,396,12499000
2020,county,48439,Tarrant,06075,San Francisco,CA,Bay Area,89,11188000,125707.86516853933,61,3977000,65196.72131147541,28,7211000
2020,county,48113,Dallas,06075,San Francisco,CA,Bay Area,313,61509000,196514.3769968051,148,13276000,89702.7027027027,165,48233000
2020,county,48085,Collin,06075,San Francisco,CA,Bay Area,109,13625000,125000.0,51,4340000,85098.03921568628,58,9285000
2020,county,48113,Dallas,06077,San Joaquin,CA,Bay Area,50,1607000,32140.0,43,1004000,23348.837209302324,7,603000
2020,county,48439,Tarrant,06081,San Mateo,CA,Bay Area,103,5830000,56601.94174757282,59,2842000,48169.49152542373,44,2988000
2020,county,48113,Dallas,06081,San Mateo,CA,Bay Area,149,16423000,110221.47651006712,116,9519000,82060.3448275862,33,6904000
2020,county,48085,Collin,06081,San Mateo,CA,Bay Area,143,15215000,106398.6013986014,62,3824000,61677.41935483871,81,11391000
2020,county,48439,Tarrant,48409,San Patricio,TX,Rural Texas,41,1468000,35804.87804878049,39,1242000,31846.153846153848,2,226000
2020,county,48439,Tarrant,06085,Santa Clara,CA,Bay Area,203,13675000,67364.53201970443,137,6760000,49343.06569343065,66,6915000
2020,county,48113,Dallas,06085,Santa Clara,CA,Bay Area,424,35064000,82698.11320754717,284,19819000,69785.21126760563,140,15245000
2020,county,48121,Denton,06085,Santa Clara,CA,Bay Area,278,22328000,80316.54676258993,84,5048000,60095.23809523809,194,17280000
2020,county,48085,Collin,06085,Santa Clara,CA,Bay Area,601,58514000,97361.06489184692,254,19993000,78712.59842519685,347,38521000
2020,county,48113,Dallas,35049,Santa Fe,NM,Rural New Mexico,32,1796000,56125.0,87,11586000,133172.41379310345,-55,-9790000
2020,county,48439,Tarrant,12115,Sarasota,FL,S.W. Florida,49,1940000,39591.836734693876,73,2468000,33808.21917808219,-24,-528000
2020,county,48113,Dallas,12115,Sarasota,FL,S.W. Florida,59,1864000,31593.22033898305,67,3580000,53432.835820895525,-8,-1716000
2020,county,48439,Tarrant,05131,Sebastian,AR,Rural Arkansas,39,1073000,27512.82051282051,54,907000,16796.296296296296,-15,166000
2020,county,48113,Dallas,05131,Sebastian,AR,Rural Arkansas,42,1895000,45119.04761904762,76,1480000,19473.684210526317,-34,415000
2020,county,48439,Tarrant,20173,Sedgwick,KS,Rural Kansas,302,12272000,40635.76158940397,182,4144000,22769.23076923077,120,8128000
2020,county,48113,Dallas,20173,Sedgwick,KS,Rural Kansas,216,6794000,31453.703703703704,176,6610000,37556.818181818184,40,184000
2020,county,48121,Denton,20173,Sedgwick,KS,Rural Kansas,110,3545000,32227.272727272728,69,3227000,46768.115942028984,41,318000
2020,county,48085,Collin,20173,Sedgwick,KS,Rural Kansas,115,3466000,30139.130434782608,48,2273000,47354.166666666664,67,1193000
2020,county,48439,Tarrant,12117,Seminole,FL,Orlando,82,3269000,39865.85365853659,58,2269000,39120.68965517241,24,1000000
2020,county,48113,Dallas,12117,Seminole,FL,Orlando,81,3181000,39271.60493827161,73,2526000,34602.739726027394,8,655000
2020,county,48085,Collin,12117,Seminole,FL,Orlando,69,3501000,50739.13043478261,44,1670000,37954.545454545456,25,1831000
2020,county,48439,Tarrant,47157,Shelby,TN,Memphis,389,8467000,21766.066838046274,244,5269000,21594.262295081968,145,3198000
2020,county,48113,Dallas,47157,Shelby,TN,Memphis,466,12889000,27658.798283261804,308,7841000,25457.79220779221,158,5048000
2020,county,48121,Denton,47157,Shelby,TN,Memphis,228,7063000,30978.070175438595,111,3422000,30828.828828828828,117,3641000
2020,county,48085,Collin,47157,Shelby,TN,Memphis,249,10357000,41594.37751004016,121,4678000,38661.157024793385,128,5679000
2020,county,48439,Tarrant,48423,Smith,TX,Rural Texas,419,11991000,28618.138424821,372,11278000,30317.204301075268,47,713000
2020,county,48113,Dallas,48423,Smith,TX,Rural Texas,720,47281000,65668.05555555556,820,29515000,35993.90243902439,-100,17766000
2020,county,48121,Denton,48423,Smith,TX,Rural Texas,295,9050000,30677.966101694914,250,10554000,42216.0,45,-1504000
2020,county,48085,Collin,48423,Smith,TX,Rural Texas,402,12710000,31616.915422885573,293,12811000,43723.54948805461,109,-101000
2020,county,48439,Tarrant,53061,Snohomish,WA,Seattle,175,5975000,34142.857142857145,101,3279000,32465.346534653465,74,2696000
2020,county,48113,Dallas,53061,Snohomish,WA,Seattle,70,2718000,38828.57142857143,84,3906000,46500.0,-14,-1188000
2020,county,48121,Denton,53061,Snohomish,WA,Seattle,134,5691000,42470.149253731346,61,2475000,40573.770491803276,73,3216000
2020,county,48085,Collin,53061,Snohomish,WA,Seattle,203,9243000,45532.0197044335,49,2824000,57632.65306122449,154,6419000
2020,county,48439,Tarrant,06095,Solano,CA,Bay Area,57,2338000,41017.54385964912,43,1319000,30674.418604651164,14,1019000
2020,county,48113,Dallas,34035,Somerset,NJ,New York,80,8101000,101262.5,64,3297000,51515.625,16,4804000
2020,county,48439,Tarrant,48425,Somervell,TX,Rural Texas,64,1656000,25875.0,100,4063000,40630.0,-36,-2407000
2020,county,48113,Dallas,06097,Sonoma,CA,Bay Area,44,2686000,61045.454545454544,32,1655000,51718.75,12,1031000
2020,county,48439,Tarrant,53063,Spokane,WA,Spokane,61,2345000,38442.62295081967,55,1833000,33327.27272727273,6,512000
2020,county,48113,Dallas,53063,Spokane,WA,Spokane,43,1241000,28860.46511627907,35,1140000,32571.428571428572,8,101000
2020,county,48439,Tarrant,29183,St. Charles,MO,St. Louis,72,2746000,38138.88888888889,81,3578000,44172.83950617284,-9,-832000
2020,county,48113,Dallas,29183,St. Charles,MO,St. Louis,53,2028000,38264.15094339623,36,1902000,52833.333333333336,17,126000
2020,county,48085,Collin,29183,St. Charles,MO,St. Louis,80,2539000,31737.5,44,2071000,47068.181818181816,36,468000
2020,county,48439,Tarrant,17163,St. Clair,IL,St. Louis,52,1043000,20057.69230769231,46,1241000,26978.260869565216,6,-198000
2020,county,48439,Tarrant,29189,St. Louis,MO,St. Louis,249,7518000,30192.77108433735,153,4068000,26588.235294117647,96,3450000
2020,county,48113,Dallas,29189,St. Louis,MO,St. Louis,331,34365000,103821.75226586103,239,10354000,43322.175732217576,92,24011000
2020,county,48121,Denton,29189,St. Louis,MO,St. Louis,146,6780000,46438.356164383564,101,6332000,62693.069306930694,45,448000
2020,county,48085,Collin,29189,St. Louis,MO,St. Louis,280,12016000,42914.28571428572,160,9181000,57381.25,120,2835000
2020,county,48439,Tarrant,29510,St. Louis city,MO,Rural Missouri,110,2554000,23218.18181818182,62,1372000,22129.032258064515,48,1182000
2020,county,48113,Dallas,29510,St. Louis city,MO,Rural Missouri,131,5199000,39687.02290076336,65,2313000,35584.61538461538,66,2886000
2020,county,48439,Tarrant,12111,St. Lucie,FL,Atlantic Coast,30,1000000,33333.333333333336,57,1854000,32526.315789473683,-27,-854000
2020,county,48439,Tarrant,22103,St. Tammany Parish,LA,New Orleans,78,3081000,39500.0,48,2025000,42187.5,30,1056000
2020,county,48113,Dallas,22103,St. Tammany Parish,LA,New Orleans,41,2970000,72439.0243902439,43,1720000,40000.0,-2,1250000
2020,county,48439,Tarrant,25025,Suffolk,MA,Boston,49,2817000,57489.795918367345,36,3677000,102138.88888888889,13,-860000
2020,county,48113,Dallas,25025,Suffolk,MA,Boston,151,11910000,78874.17218543046,126,10352000,82158.73015873016,25,1558000
2020,county,48113,Dallas,36103,Suffolk,NY,New York,100,4438000,44380.0,69,2017000,29231.884057971016,31,2421000
2020,county,48121,Denton,25025,Suffolk,MA,Boston,48,3402000,70875.0,32,1632000,51000.0,16,1770000
2020,county,48085,Collin,25025,Suffolk,MA,Boston,50,3206000,64120.0,32,2499000,78093.75,18,707000
2020,county,48439,Tarrant,39153,Summit,OH,Rural Ohio,53,1550000,29245.283018867925,39,1868000,47897.4358974359,14,-318000
2020,county,48113,Dallas,39153,Summit,OH,Rural Ohio,42,1582000,37666.666666666664,46,2066000,44913.04347826087,-4,-484000
2020,county,48113,Dallas,48439,Tarrant,TX,Dallas-Fort Worth,20137,619614000,30769.926006853057,26832,788567000,29389.0503875969,-6695,-168953000
2020,county,48121,Denton,48439,Tarrant,TX,Dallas-Fort Worth,11367,489719000,43082.51957420603,7793,306930000,39385.34582317464,3574,182789000
2020,county,48085,Collin,48439,Tarrant,TX,Dallas-Fort Worth,3702,203119000,54867.36898973528,2877,106029000,36854.01459854015,825,97090000
2020,county,48439,Tarrant,48441,Taylor,TX,Rural Texas,425,11314000,26621.176470588234,328,8932000,27231.70731707317,97,2382000
2020,county,48113,Dallas,48441,Taylor,TX,Rural Texas,204,5860000,28725.49019607843,205,5959000,29068.29268292683,-1,-99000
2020,county,48121,Denton,48441,Taylor,TX,Rural Texas,156,4627000,29660.25641025641,78,1926000,24692.30769230769,78,2701000
2020,county,48085,Collin,48441,Taylor,TX,Rural Texas,90,2830000,31444.444444444445,77,2538000,32961.03896103896,13,292000
2020,county,48113,Dallas,48449,Titus,TX,Rural Texas,80,1591000,19887.5,92,2431000,26423.91304347826,-12,-840000
2020,county,48439,Tarrant,48451,Tom Green,TX,Rural Texas,208,4805000,23100.96153846154,160,3486000,21787.5,48,1319000
2020,county,48113,Dallas,48451,Tom Green,TX,Rural Texas,100,3348000,33480.0,96,2957000,30802.083333333332,4,391000
2020,county,48121,Denton,48451,Tom Green,TX,Rural Texas,76,2285000,30065.78947368421,37,1063000,28729.72972972973,39,1222000
2020,county,48085,Collin,48451,Tom Green,TX,Rural Texas,81,2120000,26172.83950617284,29,827000,28517.241379310344,52,1293000
2020,county,48439,Tarrant,48453,Travis,TX,Austin,1146,50998000,44500.87260034904,1188,66719000,56160.77441077441,-42,-15721000
2020,county,48113,Dallas,48453,Travis,TX,Austin,1652,84038000,50870.460048426154,2251,169016000,75084.85117725456,-599,-84978000
2020,county,48121,Denton,48453,Travis,TX,Austin,575,27083000,47100.86956521739,670,50912000,75988.05970149254,-95,-23829000
2020,county,48085,Collin,48453,Travis,TX,Austin,889,46232000,52004.4994375703,874,50740000,58054.91990846682,15,-4508000
2020,county,48439,Tarrant,40143,Tulsa,OK,Tulsa,398,17137000,43057.788944723616,435,11457000,26337.931034482757,-37,5680000
2020,county,48113,Dallas,40143,Tulsa,OK,Tulsa,390,16501000,42310.256410256414,379,12505000,32994.72295514512,11,3996000
2020,county,48121,Denton,40143,Tulsa,OK,Tulsa,231,8651000,37450.21645021645,204,6713000,32906.86274509804,27,1938000
2020,county,48085,Collin,40143,Tulsa,OK,Tulsa,203,8290000,40837.43842364532,221,9104000,41194.57013574661,-18,-814000
2020,county,48113,Dallas,34039,Union,NJ,New York,49,2283000,46591.836734693876,33,1710000,51818.181818181816,16,573000
2020,county,48439,Tarrant,48459,Upshur,TX,Rural Texas,61,1112000,18229.508196721312,60,1960000,32666.666666666668,1,-848000
2020,county,48113,Dallas,48459,Upshur,TX,Rural Texas,39,727000,18641.02564102564,76,1553000,20434.21052631579,-37,-826000
2020,county,48439,Tarrant,49049,Utah,UT,Rural Utah,103,1870000,18155.339805825242,153,4616000,30169.934640522875,-50,-2746000
2020,county,48113,Dallas,49049,Utah,UT,Rural Utah,98,2748000,28040.816326530614,112,3805000,33973.21428571428,-14,-1057000
2020,county,48121,Denton,49049,Utah,UT,Rural Utah,101,1603000,15871.287128712871,157,4162000,26509.554140127388,-56,-2559000
2020,county,48085,Collin,49049,Utah,UT,Rural Utah,140,3284000,23457.14285714286,113,3203000,28345.132743362832,27,81000
2020,county,48439,Tarrant,48465,Val Verde,TX,Rural Texas,72,1415000,19652.777777777777,45,892000,19822.222222222223,27,523000
2020,county,48439,Tarrant,48467,Van Zandt,TX,Rural Texas,90,1995000,22166.666666666668,149,4323000,29013.422818791947,-59,-2328000
2020,county,48113,Dallas,48467,Van Zandt,TX,Rural Texas,300,5970000,19900.0,748,18024000,24096.25668449198,-448,-12054000
2020,county,48121,Denton,48467,Van Zandt,TX,Rural Texas,37,1118000,30216.216216216217,96,2565000,26718.75,-59,-1447000
2020,county,48085,Collin,48467,Van Zandt,TX,Rural Texas,67,1755000,26194.02985074627,138,4313000,31253.623188405796,-71,-2558000
2020,county,48439,Tarrant,06111,Ventura,CA,Los Angeles,228,7840000,34385.9649122807,94,4763000,50670.21276595745,134,3077000
2020,county,48113,Dallas,06111,Ventura,CA,Los Angeles,122,7833000,64204.91803278688,43,1599000,37186.04651162791,79,6234000
2020,county,48121,Denton,06111,Ventura,CA,Los Angeles,144,8265000,57395.833333333336,45,1839000,40866.666666666664,99,6426000
2020,county,48085,Collin,06111,Ventura,CA,Los Angeles,238,9827000,41289.91596638656,60,2764000,46066.666666666664,178,7063000
2020,county,48439,Tarrant,51810,Virginia Beach city,VA,Hampton Roads,114,2527000,22166.666666666668,76,2826000,37184.21052631579,38,-299000
2020,county,48113,Dallas,51810,Virginia Beach city,VA,Hampton Roads,77,2921000,37935.06493506493,63,1397000,22174.603174603173,14,1524000
2020,county,48439,Tarrant,12127,Volusia,FL,Atlantic Coast,41,1264000,30829.268292682926,53,2760000,52075.47169811321,-12,-1496000
2020,county,48113,Dallas,12127,Volusia,FL,Atlantic Coast,55,1589000,28890.909090909092,47,1416000,30127.659574468085,8,173000
2020,county,48121,Denton,12127,Volusia,FL,Atlantic Coast,42,852000,20285.714285714286,35,1588000,45371.42857142857,7,-736000
2020,county,48439,Tarrant,37183,Wake,NC,Raleigh,142,5567000,39204.22535211268,160,5902000,36887.5,-18,-335000
2020,county,48113,Dallas,37183,Wake,NC,Raleigh,164,9645000,58810.9756097561,253,13488000,53312.25296442688,-89,-3843000
2020,county,48121,Denton,37183,Wake,NC,Raleigh,75,5823000,77640.0,107,7119000,66532.71028037384,-32,-1296000
2020,county,48085,Collin,37183,Wake,NC,Raleigh,172,7717000,44866.27906976744,180,8375000,46527.77777777778,-8,-658000
2020,county,48439,Tarrant,48471,Walker,TX,Rural Texas,73,1491000,20424.657534246577,74,1558000,21054.054054054053,-1,-67000
2020,county,48113,Dallas,48471,Walker,TX,Rural Texas,67,1388000,20716.417910447763,71,807000,11366.197183098591,-4,581000
2020,county,48439,Tarrant,05143,Washington,AR,Rural Arkansas,71,3115000,43873.23943661972,117,3635000,31068.37606837607,-46,-520000
2020,county,48439,Tarrant,41067,Washington,OR,Portland,70,4045000,57785.71428571428,70,2867000,40957.142857142855,0,1178000
2020,county,48113,Dallas,05143,Washington,AR,Rural Arkansas,114,3751000,32903.508771929824,118,3731000,31618.64406779661,-4,20000
2020,county,48113,Dallas,41067,Washington,OR,Portland,114,5532000,48526.31578947369,93,4242000,45612.903225806454,21,1290000
2020,county,48121,Denton,05143,Washington,AR,Rural Arkansas,42,1889000,44976.19047619047,66,2371000,35924.242424242424,-24,-482000
2020,county,48121,Denton,41067,Washington,OR,Portland,50,2703000,54060.0,41,1580000,38536.58536585366,9,1123000
2020,county,48085,Collin,41067,Washington,OR,Portland,170,6901000,40594.117647058825,78,2844000,36461.53846153846,92,4057000
2020,county,48085,Collin,05143,Washington,AR,Rural Arkansas,71,2389000,33647.887323943665,74,2377000,32121.62162162162,-3,12000
2020,county,48439,Tarrant,32031,Washoe,NV,Rural Nevada,96,2151000,22406.25,58,2486000,42862.06896551724,38,-335000
2020,county,48113,Dallas,32031,Washoe,NV,Rural Nevada,62,4363000,70370.96774193548,63,5834000,92603.1746031746,-1,-1471000
2020,county,48121,Denton,32031,Washoe,NV,Rural Nevada,61,2854000,46786.88524590164,45,3115000,69222.22222222222,16,-261000
2020,county,48439,Tarrant,26161,Washtenaw,MI,Rural Michigan,40,1868000,46700.0,40,1159000,28975.0,0,709000
2020,county,48113,Dallas,26161,Washtenaw,MI,Rural Michigan,75,3836000,51146.666666666664,64,4285000,66953.125,11,-449000
2020,county,48439,Tarrant,26163,Wayne,MI,Detroit,196,4224000,21551.020408163266,137,4423000,32284.671532846714,59,-199000
2020,county,48113,Dallas,26163,Wayne,MI,Detroit,212,6449000,30419.811320754718,157,4048000,25783.43949044586,55,2401000
2020,county,48121,Denton,26163,Wayne,MI,Detroit,127,5701000,44889.76377952756,55,2530000,46000.0,72,3171000
2020,county,48085,Collin,26163,Wayne,MI,Detroit,102,3100000,30392.156862745098,64,3791000,59234.375,38,-691000
2020,county,48439,Tarrant,48479,Webb,TX,Rural Texas,122,2664000,21836.06557377049,93,1535000,16505.37634408602,29,1129000
2020,county,48113,Dallas,48479,Webb,TX,Rural Texas,205,2863000,13965.853658536585,148,2013000,13601.351351351352,57,850000
2020,county,48439,Tarrant,08123,Weld,CO,Rural Colorado,55,1838000,33418.181818181816,54,1927000,35685.18518518518,1,-89000
2020,county,48113,Dallas,08123,Weld,CO,Rural Colorado,36,1284000,35666.666666666664,43,1859000,43232.558139534885,-7,-575000
2020,county,48113,Dallas,36119,Westchester,NY,New York,96,8470000,88229.16666666667,39,7174000,183948.71794871794,57,1296000
2020,county,48439,Tarrant,48485,Wichita,TX,Rural Texas,371,14543000,39199.46091644205,361,10396000,28797.783933518007,10,4147000
2020,county,48113,Dallas,48485,Wichita,TX,Rural Texas,234,5964000,25487.17948717949,227,4436000,19541.850220264318,7,1528000
2020,county,48121,Denton,48485,Wichita,TX,Rural Texas,169,5524000,32686.390532544377,169,5025000,29733.72781065089,0,499000
2020,county,48085,Collin,48485,Wichita,TX,Rural Texas,129,3823000,29635.658914728683,103,3092000,30019.417475728154,26,731000
2020,county,48439,Tarrant,17197,Will,IL,Chicago,126,6108000,48476.19047619047,55,2522000,45854.545454545456,71,3586000
2020,county,48113,Dallas,17197,Will,IL,Chicago,96,2813000,29302.083333333332,72,2557000,35513.88888888889,24,256000
2020,county,48439,Tarrant,48491,Williamson,TX,Austin,468,17141000,36626.068376068375,644,29207000,45352.48447204969,-176,-12066000
2020,county,48439,Tarrant,47187,Williamson,TN,Nashville,61,5574000,91377.04918032787,66,6153000,93227.27272727272,-5,-579000
2020,county,48113,Dallas,48491,Williamson,TX,Austin,447,18662000,41749.44071588367,714,32188000,45081.2324929972,-267,-13526000
2020,county,48113,Dallas,47187,Williamson,TN,Nashville,52,3619000,69596.15384615384,65,8075000,124230.76923076923,-13,-4456000
2020,county,48121,Denton,48491,Williamson,TX,Austin,367,16238000,44245.23160762943,427,17299000,40512.88056206089,-60,-1061000
2020,county,48121,Denton,47187,Williamson,TN,Nashville,63,3307000,52492.06349206349,95,6662000,70126.31578947368,-32,-3355000
2020,county,48085,Collin,48491,Williamson,TX,Austin,489,19209000,39282.20858895705,427,21799000,51051.52224824356,62,-2590000
2020,county,48085,Collin,47187,Williamson,TN,Nashville,59,3488000,59118.64406779661,69,3127000,45318.840579710144,-10,361000
2020,county,48439,Tarrant,48497,Wise,TX,Dallas-Fort Worth,1199,28448000,23726.438698915765,2360,74876000,31727.118644067796,-1161,-46428000
2020,county,48113,Dallas,48497,Wise,TX,Dallas-Fort Worth,108,3456000,32000.0,163,3743000,22963.19018404908,-55,-287000
2020,county,48121,Denton,48497,Wise,TX,Dallas-Fort Worth,589,21014000,35677.41935483871,1075,34212000,31825.116279069767,-486,-13198000
2020,county,48085,Collin,48497,Wise,TX,Dallas-Fort Worth,40,1296000,32400.0,96,5348000,55708.333333333336,-56,-4052000
2020,county,48439,Tarrant,48499,Wood,TX,Rural Texas,86,1951000,22686.04651162791,200,6193000,30965.0,-114,-4242000
2020,county,48113,Dallas,48499,Wood,TX,Rural Texas,119,3069000,25789.915966386554,273,11478000,42043.956043956045,-154,-8409000
2020,county,48121,Denton,48499,Wood,TX,Rural Texas,75,3779000,50386.666666666664,87,4329000,49758.620689655174,-12,-550000
2020,county,48085,Collin,48499,Wood,TX,Rural Texas,79,2502000,31670.886075949365,188,12620000,67127.65957446808,-109,-10118000
2020,county,48113,Dallas,25027,Worcester,MA,Rural Massachusetts,56,1756000,31357.14285714286,52,2360000,45384.61538461538,4,-604000
2020,county,48439,Tarrant,04025,Yavapai,AZ,Rural Arizona,43,1444000,33581.395348837206,44,2074000,47136.36363636364,-1,-630000
2020,county,48439,Tarrant,48503,Young,TX,Rural Texas,55,1193000,21690.909090909092,82,2217000,27036.585365853658,-27,-1024000
2020,total,48439,Tarrant,96000,,,,111023,3640221000,32787.989875971645,110489,3931794000,35585.38859071944,534,-291573000
2020,total,48113,Dallas,96000,,,,121107,5416084000,44721.477701536656,155246,6204809000,39967.59336794507,-34139,-788725000
2020,total,48121,Denton,96000,,,,82159,3491003000,42490.81658734892,62426,2593654000,41547.656425207446,19733,897349000
2020,total,48085,Collin,96000,,,,92655,4039088000,43592.768873779074,68177,3006598000,44099.88705868548,24478,1032490000
2021,county,48439,Tarrant,16001,Ada,ID,Rural Idaho,70,2369000,33842.857142857145,54,2444000,45259.25925925926,16,-75000
2021,county,48113,Dallas,16001,Ada,ID,Rural Idaho,61,2090000,34262.29508196721,68,3726000,54794.117647058825,-7,-1636000
2021,county,48085,Collin,16001,Ada,ID,Rural Idaho,74,4536000,61297.2972972973,52,1738000,33423.07692307692,22,2798000
2021,county,48439,Tarrant,08001,Adams,CO,Denver,161,5415000,33633.54037267081,89,3247000,36483.14606741573,72,2168000
2021,county,48113,Dallas,08001,Adams,CO,Denver,135,4306000,31896.296296296296,100,3872000,38720.0,35,434000
2021,county,48121,Denton,08001,Adams,CO,Denver,140,7094000,50671.42857142857,51,1965000,38529.41176470588,89,5129000
2021,county,48113,Dallas,12001,Alachua,FL,Rural Florida,60,2792000,46533.333333333336,40,2412000,60300.0,20,380000
2021,county,48439,Tarrant,06001,Alameda,CA,Bay Area,316,20794000,65803.79746835443,136,5933000,43625.0,180,14861000
2021,county,48113,Dallas,06001,Alameda,CA,Bay Area,506,46504000,91905.13833992094,234,12495000,53397.4358974359,272,34009000
2021,county,48121,Denton,06001,Alameda,CA,Bay Area,366,33005000,90177.5956284153,50,2596000,51920.0,316,30409000
2021,county,48085,Collin,06001,Alameda,CA,Bay Area,834,60538000,72587.52997601918,125,7330000,58640.0,709,53208000
2021,county,48113,Dallas,51510,Alexandria city,VA,D.C.,64,4578000,71531.25,47,6729000,143170.21276595743,17,-2151000
2021,county,48439,Tarrant,42003,Allegheny,PA,Pittsburgh,102,3882000,38058.82352941176,91,4139000,45483.51648351648,11,-257000
2021,county,48113,Dallas,42003,Allegheny,PA,Pittsburgh,157,7044000,44866.24203821656,154,6570000,42662.33766233766,3,474000
2021,county,48121,Denton,42003,Allegheny,PA,Pittsburgh,102,7453000,73068.62745098039,36,2008000,55777.77777777778,66,5445000
2021,county,48085,Collin,42003,Allegheny,PA,Pittsburgh,155,9780000,63096.77419354839,47,2305000,49042.55319148936,108,7475000
2021,county,48113,Dallas,18003,Allen,IN,Rural Indiana,42,1228000,29238.095238095237,85,1409000,16576.470588235294,-43,-181000
2021,county,48439,Tarrant,02020,Anchorage Borough,AK,Rural Alaska,82,2422000,29536.585365853658,44,879000,19977.272727272728,38,1543000
2021,county,48439,Tarrant,48001,Anderson,TX,Rural Texas,83,1593000,19192.77108433735,158,3893000,24639.240506329115,-75,-2300000
2021,county,48113,Dallas,48001,Anderson,TX,Rural Texas,129,3265000,25310.077519379844,187,3240000,17326.20320855615,-58,25000
2021,county,48121,Denton,48001,Anderson,TX,Rural Texas,35,1006000,28742.85714285714,46,1257000,27326.08695652174,-11,-251000
2021,county,48439,Tarrant,48005,Angelina,TX,Rural Texas,60,1237000,20616.666666666668,64,1478000,23093.75,-4,-241000
2021,county,48113,Dallas,48005,Angelina,TX,Rural Texas,79,1499000,18974.683544303796,90,2293000,25477.777777777777,-11,-794000
2021,county,48113,Dallas,24003,Anne Arundel,MD,Baltimore,62,3934000,63451.6129032258,38,1182000,31105.263157894737,24,2752000
2021,county,48439,Tarrant,08005,Arapahoe,CO,Denver,281,9897000,35220.640569395015,211,8553000,40535.54502369668,70,1344000
2021,county,48113,Dallas,08005,Arapahoe,CO,Denver,220,9739000,44268.181818181816,242,13769000,56896.694214876035,-22,-4030000
2021,county,48121,Denton,08005,Arapahoe,CO,Denver,139,6156000,44287.76978417266,138,5848000,42376.811594202896,1,308000
2021,county,48085,Collin,08005,Arapahoe,CO,Denver,181,8564000,47314.91712707182,137,5920000,43211.67883211679,44,2644000
2021,county,48439,Tarrant,51013,Arlington,VA,D.C.,47,3449000,73382.97872340426,29,2023000,69758.62068965517,18,1426000
2021,county,48113,Dallas,51013,Arlington,VA,D.C.,106,8058000,76018.8679245283,60,6672000,111200.0,46,1386000
2021,county,48085,Collin,51013,Arlington,VA,D.C.,31,2460000,79354.83870967742,34,3276000,96352.94117647059,-3,-816000
2021,county,48113,Dallas,24005,Baltimore,MD,Baltimore,113,5256000,46513.27433628318,46,1929000,41934.782608695656,67,3327000
2021,county,48439,Tarrant,24510,Baltimore city,MD,Baltimore,32,1125000,35156.25,30,1245000,41500.0,2,-120000
2021,county,48113,Dallas,24510,Baltimore city,MD,Baltimore,72,2979000,41375.0,53,2712000,51169.811320754714,19,267000
2021,county,48439,Tarrant,48021,Bastrop,TX,Austin,36,1910000,53055.555555555555,60,1630000,27166.666666666668,-24,280000
2021,county,48113,Dallas,48021,Bastrop,TX,Austin,44,830000,18863.636363636364,88,2927000,33261.36363636364,-44,-2097000
2021,county,48439,Tarrant,48027,Bell,TX,Rural Texas,572,14698000,25695.804195804194,486,11571000,23808.64197530864,86,3127000
2021,county,48113,Dallas,48027,Bell,TX,Rural Texas,513,11509000,22434.697855750488,418,11326000,27095.693779904308,95,183000
2021,county,48121,Denton,48027,Bell,TX,Rural Texas,240,7562000,31508.333333333332,158,5270000,33354.43037974684,82,2292000
2021,county,48085,Collin,48027,Bell,TX,Rural Texas,214,7037000,32883.17757009346,198,6252000,31575.757575757576,16,785000
2021,county,48439,Tarrant,05007,Benton,AR,Rural Arkansas,122,6443000,52811.475409836065,162,6826000,42135.8024691358,-40,-383000
2021,county,48113,Dallas,05007,Benton,AR,Rural Arkansas,170,12345000,72617.64705882352,224,20560000,91785.71428571429,-54,-8215000
2021,county,48121,Denton,05007,Benton,AR,Rural Arkansas,120,8945000,74541.66666666667,131,7050000,53816.79389312977,-11,1895000
2021,county,48085,Collin,05007,Benton,AR,Rural Arkansas,200,11849000,59245.0,159,10744000,67572.32704402515,41,1105000
2021,county,48113,Dallas,34003,Bergen,NJ,New York,93,5457000,58677.41935483871,66,4002000,60636.36363636364,27,1455000
2021,county,48439,Tarrant,35001,Bernalillo,NM,Albuquerque,188,5421000,28835.106382978724,110,4703000,42754.545454545456,78,718000
2021,county,48113,Dallas,35001,Bernalillo,NM,Albuquerque,159,5197000,32685.53459119497,134,6332000,47253.73134328358,25,-1135000
2021,county,48121,Denton,35001,Bernalillo,NM,Albuquerque,85,4512000,53082.35294117647,64,1996000,31187.5,21,2516000
2021,county,48085,Collin,35001,Bernalillo,NM,Albuquerque,158,6665000,42183.54430379747,62,2514000,40548.3870967742,96,4151000
2021,county,48439,Tarrant,48029,Bexar,TX,San Antonio,1197,40068000,33473.68421052631,1258,38871000,30899.046104928457,-61,1197000
2021,county,48113,Dallas,48029,Bexar,TX,San Antonio,1382,54071000,39125.180897250364,1224,50917000,41598.856209150326,158,3154000
2021,county,48121,Denton,48029,Bexar,TX,San Antonio,661,29314000,44347.95763993949,516,19014000,36848.83720930233,145,10300000
2021,county,48085,Collin,48029,Bexar,TX,San Antonio,816,34886000,42752.450980392154,587,41525000,70741.05621805791,229,-6639000
2021,county,48439,Tarrant,48035,Bosque,TX,Rural Texas,78,1856000,23794.871794871793,111,5991000,53972.97297297297,-33,-4135000
2021,county,48439,Tarrant,22015,Bossier Parish,LA,Rural Louisiana,186,3652000,19634.40860215054,88,2383000,27079.545454545456,98,1269000
2021,county,48113,Dallas,22015,Bossier Parish,LA,Rural Louisiana,208,3526000,16951.923076923078,77,1268000,16467.532467532466,131,2258000
2021,county,48439,Tarrant,08013,Boulder,CO,Denver,46,1912000,41565.217391304344,62,3246000,52354.83870967742,-16,-1334000
2021,county,48113,Dallas,08013,Boulder,CO,Denver,42,2152000,51238.09523809524,87,6753000,77620.68965517242,-45,-4601000
2021,county,48121,Denton,08013,Boulder,CO,Denver,41,2661000,64902.439024390245,45,1960000,43555.555555555555,-4,701000
2021,county,48085,Collin,08013,Boulder,CO,Denver,41,1982000,48341.46341463415,42,3164000,75333.33333333333,-1,-1182000
2021,county,48439,Tarrant,48037,Bowie,TX,Rural Texas,177,4499000,25418.0790960452,167,4122000,24682.63473053892,10,377000
2021,county,48113,Dallas,48037,Bowie,TX,Rural Texas,209,5556000,26583.73205741627,151,3268000,21642.384105960264,58,2288000
2021,county,48121,Denton,48037,Bowie,TX,Rural Texas,79,2063000,26113.92405063291,43,1085000,25232.558139534885,36,978000
2021,county,48085,Collin,48037,Bowie,TX,Rural Texas,82,3047000,37158.53658536585,92,3115000,33858.69565217391,-10,-68000
2021,county,48439,Tarrant,48039,Brazoria,TX,Houston,144,4254000,29541.666666666668,185,4961000,26816.216216216217,-41,-707000
2021,county,48113,Dallas,48039,Brazoria,TX,Houston,118,4524000,38338.983050847455,213,5793000,27197.183098591548,-95,-1269000
2021,county,48121,Denton,48039,Brazoria,TX,Houston,76,2454000,32289.473684210527,86,2330000,27093.023255813954,-10,124000
2021,county,48085,Collin,48039,Brazoria,TX,Houston,85,2808000,33035.294117647056,82,2835000,34573.170731707316,3,-27000
2021,county,48439,Tarrant,48041,Brazos,TX,Rural Texas,305,8215000,26934.426229508197,233,8319000,35703.86266094421,72,-104000
2021,county,48113,Dallas,48041,Brazos,TX,Rural Texas,357,12856000,36011.204481792716,214,8590000,40140.18691588785,143,4266000
2021,county,48121,Denton,48041,Brazos,TX,Rural Texas,164,3999000,24384.146341463416,108,4385000,40601.851851851854,56,-386000
2021,county,48085,Collin,48041,Brazos,TX,Rural Texas,180,6650000,36944.444444444445,133,7032000,52872.18045112782,47,-382000
2021,county,48439,Tarrant,12009,Brevard,FL,Atlantic Coast,74,2271000,30689.18918918919,107,5049000,47186.91588785047,-33,-2778000
2021,county,48113,Dallas,12009,Brevard,FL,Atlantic Coast,64,3339000,52171.875,66,2808000,42545.454545454544,-2,531000
2021,county,48121,Denton,12009,Brevard,FL,Atlantic Coast,48,2858000,59541.666666666664,69,3255000,47173.913043478264,-21,-397000
2021,county,48085,Collin,12009,Brevard,FL,Atlantic Coast,52,1809000,34788.46153846154,38,2987000,78605.26315789473,14,-1178000
2021,county,48439,Tarrant,36005,Bronx,NY,New York,91,2166000,23802.197802197803,61,3581000,58704.91803278688,30,-1415000
2021,county,48113,Dallas,36005,Bronx,NY,New York,122,4103000,33631.147540983606,47,1453000,30914.893617021276,75,2650000
2021,county,48439,Tarrant,12011,Broward,FL,Miami,268,9208000,34358.20895522388,157,6179000,39356.68789808917,111,3029000
2021,county,48113,Dallas,12011,Broward,FL,Miami,338,11185000,33091.71597633136,278,14882000,53532.374100719426,60,-3697000
2021,county,48121,Denton,12011,Broward,FL,Miami,206,11164000,54194.17475728155,114,5172000,45368.42105263158,92,5992000
2021,county,48085,Collin,12011,Broward,FL,Miami,330,17280000,52363.63636363636,132,5427000,41113.63636363636,198,11853000
2021,county,48439,Tarrant,48049,Brown,TX,Rural Texas,48,1116000,23250.0,75,1594000,21253.333333333332,-27,-478000
2021,county,48113,Dallas,48049,Brown,TX,Rural Texas,37,535000,14459.45945945946,50,1503000,30060.0,-13,-968000
2021,county,48085,Collin,40013,Bryan,OK,Rural Oklahoma,60,1824000,30400.0,101,3567000,35316.83168316832,-41,-1743000
2021,county,48113,Dallas,37021,Buncombe,NC,Asheville,31,779000,25129.032258064515,46,4067000,88413.04347826086,-15,-3288000
2021,county,48439,Tarrant,34005,Burlington,NJ,Philadelphia,73,2121000,29054.794520547945,38,1185000,31184.21052631579,35,936000
2021,county,48439,Tarrant,48053,Burnet,TX,Rural Texas,50,1447000,28940.0,56,5227000,93339.28571428571,-6,-3780000
2021,county,48439,Tarrant,22017,Caddo Parish,LA,Rural Louisiana,501,8313000,16592.814371257486,153,2283000,14921.56862745098,348,6030000
2021,county,48113,Dallas,22017,Caddo Parish,LA,Rural Louisiana,624,10115000,16209.935897435897,256,4007000,15652.34375,368,6108000
2021,county,48121,Denton,22017,Caddo Parish,LA,Rural Louisiana,255,4256000,16690.196078431374,79,2418000,30607.59493670886,176,1838000
2021,county,48085,Collin,22017,Caddo Parish,LA,Rural Louisiana,156,4074000,26115.384615384617,62,1368000,22064.516129032258,94,2706000
2021,county,48113,Dallas,22019,Calcasieu Parish,LA,Rural Louisiana,200,3023000,15115.0,38,796000,20947.36842105263,162,2227000
2021,county,48439,Tarrant,48061,Cameron,TX,Rural Texas,146,3492000,23917.80821917808,149,3428000,23006.71140939597,-3,64000
2021,county,48113,Dallas,48061,Cameron,TX,Rural Texas,165,4067000,24648.484848484848,240,9151000,38129.166666666664,-75,-5084000
2021,county,48121,Denton,48061,Cameron,TX,Rural Texas,42,1476000,35142.857142857145,66,1824000,27636.363636363636,-24,-348000
2021,county,48085,Collin,48061,Cameron,TX,Rural Texas,48,1625000,33854.166666666664,76,3569000,46960.52631578947,-28,-1944000
2021,county,48439,Tarrant,40017,Canadian,OK,Oklahoma City,66,1735000,26287.878787878788,105,3366000,32057.14285714286,-39,-1631000
2021,county,48113,Dallas,40017,Canadian,OK,Oklahoma City,55,1682000,30581.81818181818,45,1642000,36488.88888888889,10,40000
2021,county,48439,Tarrant,40019,Carter,OK,Rural Oklahoma,33,874000,26484.848484848484,72,1663000,23097.222222222223,-39,-789000
2021,county,48113,Dallas,40019,Carter,OK,Rural Oklahoma,37,936000,25297.297297297297,42,782000,18619.04761904762,-5,154000
2021,county,48121,Denton,40019,Carter,OK,Rural Oklahoma,57,1646000,28877.19298245614,79,2055000,26012.6582278481,-22,-409000
2021,county,48113,Dallas,48067,Cass,TX,Rural Texas,37,864000,23351.35135135135,62,2286000,36870.967741935485,-25,-1422000
2021,county,48439,Tarrant,45019,Charleston,SC,Charleston,46,2832000,61565.217391304344,55,4378000,79600.0,-9,-1546000
2021,county,48113,Dallas,45019,Charleston,SC,Charleston,60,2707000,45116.666666666664,59,6792000,115118.64406779662,1,-4085000
2021,county,48439,Tarrant,13051,Chatham,GA,Savannah,40,1155000,28875.0,71,2185000,30774.647887323943,-31,-1030000
2021,county,48113,Dallas,13051,Chatham,GA,Savannah,51,1576000,30901.960784313724,61,3731000,61163.934426229505,-10,-2155000
2021,county,48439,Tarrant,48073,Cherokee,TX,Rural Texas,49,1145000,23367.34693877551,63,1960000,31111.11111111111,-14,-815000
2021,county,48113,Dallas,48073,Cherokee,TX,Rural Texas,67,1165000,17388.059701492537,78,2705000,34679.48717948718,-11,-1540000
2021,county,48113,Dallas,42029,Chester,PA,Philadelphia,64,2726000,42593.75,52,6562000,126192.30769230769,12,-3836000
2021,county,48439,Tarrant,32003,Clark,NV,Las Vegas,586,33769000,57626.27986348123,344,17351000,50438.95348837209,242,16418000
2021,county,48439,Tarrant,53011,Clark,WA,Portland,170,5190000,30529.41176470588,46,1923000,41804.34782608696,124,3267000
2021,county,48113,Dallas,32003,Clark,NV,Las Vegas,614,18292000,29791.530944625407,397,25471000,64158.690176322416,217,-7179000
2021,county,48113,Dallas,53011,Clark,WA,Portland,72,3419000,47486.11111111111,45,2340000,52000.0,27,1079000
2021,county,48121,Denton,32003,Clark,NV,Las Vegas,344,21347000,62055.232558139534,191,8005000,41910.9947643979,153,13342000
2021,county,48085,Collin,32003,Clark,NV,Las Vegas,458,23117000,50473.799126637554,219,12139000,55429.223744292234,239,10978000
2021,county,48085,Collin,53011,Clark,WA,Portland,137,7073000,51627.73722627737,33,1812000,54909.09090909091,104,5261000
2021,county,48439,Tarrant,29047,Clay,MO,Kansas City,60,1367000,22783.333333333332,52,3738000,71884.61538461539,8,-2371000
2021,county,48113,Dallas,29047,Clay,MO,Kansas City,54,1790000,33148.148148148146,41,1611000,39292.68292682927,13,179000
2021,county,48121,Denton,29047,Clay,MO,Kansas City,50,1821000,36420.0,41,1279000,31195.121951219513,9,542000
2021,county,48113,Dallas,13063,Clayton,GA,Atlanta,68,1260000,18529.41176470588,59,1493000,25305.084745762713,9,-233000
2021,county,48439,Tarrant,40027,Cleveland,OK,Oklahoma City,135,5602000,41496.2962962963,175,5974000,34137.142857142855,-40,-372000
2021,county,48113,Dallas,40027,Cleveland,OK,Oklahoma City,129,4065000,31511.627906976744,164,7127000,43457.31707317073,-35,-3062000
2021,county,48121,Denton,40027,Cleveland,OK,Oklahoma City,95,3878000,40821.05263157895,65,2666000,41015.38461538462,30,1212000
2021,county,48085,Collin,40027,Cleveland,OK,Oklahoma City,140,5129000,36635.71428571428,94,3367000,35819.14893617021,46,1762000
2021,county,48439,Tarrant,13067,Cobb,GA,Atlanta,156,6196000,39717.94871794872,118,3885000,32923.72881355932,38,2311000
2021,county,48113,Dallas,13067,Cobb,GA,Atlanta,187,6753000,36112.29946524064,161,7973000,49521.739130434784,26,-1220000
2021,county,48121,Denton,13067,Cobb,GA,Atlanta,71,4061000,57197.18309859155,84,3128000,37238.09523809524,-13,933000
2021,county,48085,Collin,13067,Cobb,GA,Atlanta,120,6207000,51725.0,94,5092000,54170.21276595745,26,1115000
2021,county,48439,Tarrant,12021,Collier,FL,S.W. Florida,35,1807000,51628.57142857143,82,3547000,43256.09756097561,-47,-1740000
2021,county,48113,Dallas,12021,Collier,FL,S.W. Florida,50,25373000,507460.0,44,13451000,305704.54545454547,6,11922000
2021,county,48439,Tarrant,48085,Collin,TX,Dallas-Fort Worth,2789,107682000,38609.537468626746,3691,145520000,39425.629910593336,-902,-37838000
2021,county,48113,Dallas,48085,Collin,TX,Dallas-Fort Worth,15064,711869000,47256.30642591609,24693,1162634000,47083.54594419471,-9629,-450765000
2021,county,48121,Denton,48085,Collin,TX,Dallas-Fort Worth,14222,830164000,58371.81830966109,13466,651473000,48379.10292588742,756,178691000
2021,county,48439,Tarrant,48091,Comal,TX,San Antonio,97,10304000,106226.80412371134,190,9283000,48857.89473684211,-93,1021000
2021,county,48113,Dallas,48091,Comal,TX,San Antonio,98,4457000,45479.5918367347,144,6105000,42395.833333333336,-46,-1648000
2021,county,48121,Denton,48091,Comal,TX,San Antonio,82,4522000,55146.34146341463,115,7952000,69147.82608695653,-33,-3430000
2021,county,48085,Collin,48091,Comal,TX,San Antonio,57,2391000,41947.36842105263,97,6493000,66938.14432989691,-40,-4102000
2021,county,48439,Tarrant,40031,Comanche,OK,Rural Oklahoma,149,3429000,23013.422818791947,141,2444000,17333.333333333332,8,985000
2021,county,48113,Dallas,40031,Comanche,OK,Rural Oklahoma,91,1523000,16736.263736263736,110,1810000,16454.545454545456,-19,-287000
2021,county,48121,Denton,40031,Comanche,OK,Rural Oklahoma,45,1342000,29822.222222222223,48,1089000,22687.5,-3,253000
2021,county,48439,Tarrant,06013,Contra Costa,CA,Bay Area,270,16557000,61322.22222222222,52,1884000,36230.769230769234,218,14673000
2021,county,48113,Dallas,06013,Contra Costa,CA,Bay Area,243,25821000,106259.25925925926,83,4279000,51554.21686746988,160,21542000
2021,county,48085,Collin,06013,Contra Costa,CA,Bay Area,427,30137000,70578.45433255269,76,4416000,58105.26315789474,351,25721000
2021,county,48439,Tarrant,17031,Cook,IL,Chicago,917,42556000,46407.85169029444,345,11857000,34368.115942028984,572,30699000
2021,county,48113,Dallas,17031,Cook,IL,Chicago,1544,158313000,102534.32642487047,648,46305000,71458.33333333333,896,112008000
2021,county,48121,Denton,17031,Cook,IL,Chicago,680,35751000,52575.0,157,7538000,48012.738853503186,523,28213000
2021,county,48085,Collin,17031,Cook,IL,Chicago,1096,57523000,52484.48905109489,254,14831000,58389.76377952756,842,42692000
2021,county,48439,Tarrant,48097,Cooke,TX,Rural Texas,76,2102000,27657.894736842107,155,10604000,68412.90322580645,-79,-8502000
2021,county,48113,Dallas,48097,Cooke,TX,Rural Texas,81,2281000,28160.493827160495,153,8930000,58366.013071895424,-72,-6649000
2021,county,48121,Denton,48097,Cooke,TX,Rural Texas,487,16122000,33104.722792607805,1004,35988000,35844.62151394422,-517,-19866000
2021,county,48085,Collin,48097,Cooke,TX,Rural Texas,52,2776000,53384.61538461538,107,6629000,61953.27102803739,-55,-3853000
2021,county,48439,Tarrant,48099,Coryell,TX,Rural Texas,116,2235000,19267.241379310344,146,2411000,16513.698630136987,-30,-176000
2021,county,48113,Dallas,48099,Coryell,TX,Rural Texas,77,1347000,17493.506493506495,113,1153000,10203.53982300885,-36,194000
2021,county,48439,Tarrant,37051,Cumberland,NC,Rural North Carolina,60,1352000,22533.333333333332,54,1164000,21555.555555555555,6,188000
2021,county,48113,Dallas,37051,Cumberland,NC,Rural North Carolina,74,1841000,24878.37837837838,44,992000,22545.454545454544,30,849000
2021,county,48439,Tarrant,39035,Cuyahoga,OH,Cleveland,103,3295000,31990.29126213592,86,3401000,39546.51162790698,17,-106000
2021,county,48113,Dallas,39035,Cuyahoga,OH,Cleveland,172,9066000,52709.3023255814,114,5723000,50201.754385964916,58,3343000
2021,county,48121,Denton,39035,Cuyahoga,OH,Cleveland,51,2318000,45450.98039215686,44,2623000,59613.63636363636,7,-305000
2021,county,48085,Collin,39035,Cuyahoga,OH,Cleveland,104,3478000,33442.307692307695,34,1102000,32411.764705882353,70,2376000
2021,county,48113,Dallas,27037,Dakota,MN,Minneapolis,83,3392000,40867.469879518074,49,3116000,63591.836734693876,34,276000
2021,county,48439,Tarrant,48113,Dallas,TX,Dallas-Fort Worth,25364,796745000,31412.434947169215,19402,693542000,35745.90248427997,5962,103203000
2021,county,48121,Denton,48113,Dallas,TX,Dallas-Fort Worth,18195,791459000,43498.70843638362,11050,389078000,35210.67873303167,7145,402381000
2021,county,48085,Collin,48113,Dallas,TX,Dallas-Fort Worth,24693,1162634000,47083.54594419471,15064,711869000,47256.30642591609,9629,450765000
2021,county,48439,Tarrant,55025,Dane,WI,Madison,50,1691000,33820.0,41,1705000,41585.365853658535,9,-14000
2021,county,48113,Dallas,55025,Dane,WI,Madison,98,3612000,36857.142857142855,53,2809000,53000.0,45,803000
2021,county,48121,Denton,55025,Dane,WI,Madison,89,4793000,53853.93258426966,30,2422000,80733.33333333333,59,2371000
2021,county,48113,Dallas,42043,Dauphin,PA,Rural Pennsylvania,49,1736000,35428.57142857143,62,1033000,16661.290322580644,-13,703000
2021,county,48439,Tarrant,47037,Davidson,TN,Nashville,154,6934000,45025.97402597403,123,4948000,40227.64227642276,31,1986000
2021,county,48113,Dallas,47037,Davidson,TN,Nashville,260,13977000,53757.692307692305,284,22231000,78278.1690140845,-24,-8254000
2021,county,48121,Denton,47037,Davidson,TN,Nashville,62,2299000,37080.645161290326,91,5517000,60626.37362637363,-29,-3218000
2021,county,48085,Collin,47037,Davidson,TN,Nashville,87,3757000,43183.90804597701,75,4912000,65493.333333333336,12,-1155000
2021,county,48439,Tarrant,49011,Davis,UT,Rural Utah,87,2288000,26298.850574712644,58,1412000,24344.827586206895,29,876000
2021,county,48439,Tarrant,13089,DeKalb,GA,Atlanta,100,3452000,34520.0,93,3123000,33580.645161290326,7,329000
2021,county,48113,Dallas,13089,DeKalb,GA,Atlanta,223,8555000,38363.22869955157,183,9450000,51639.34426229508,40,-895000
2021,county,48121,Denton,13089,DeKalb,GA,Atlanta,88,3864000,43909.09090909091,58,3717000,64086.206896551725,30,147000
2021,county,48085,Collin,13089,DeKalb,GA,Atlanta,100,4677000,46770.0,48,1628000,33916.666666666664,52,3049000
2021,county,48439,Tarrant,28033,DeSoto,MS,Memphis,48,1011000,21062.5,62,2086000,33645.16129032258,-14,-1075000
2021,county,48439,Tarrant,48121,Denton,TX,Dallas-Fort Worth,7828,361152000,46135.922330097084,10884,544871000,50061.65012862918,-3056,-183719000
2021,county,48113,Dallas,48121,Denton,TX,Dallas-Fort Worth,11050,389078000,35210.67873303167,18195,791459000,43498.70843638362,-7145,-402381000
2021,county,48085,Collin,48121,Denton,TX,Dallas-Fort Worth,13466,651473000,48379.10292588742,14222,830164000,58371.81830966109,-756,-178691000
2021,county,48439,Tarrant,08031,Denver,CO,Denver,215,8574000,39879.06976744186,200,9452000,47260.0,15,-878000
2021,county,48113,Dallas,08031,Denver,CO,Denver,330,30157000,91384.84848484848,434,28751000,66246.54377880185,-104,1406000
2021,county,48121,Denton,08031,Denver,CO,Denver,96,6699000,69781.25,82,4440000,54146.34146341463,14,2259000
2021,county,48085,Collin,08031,Denver,CO,Denver,115,6661000,57921.739130434784,120,6974000,58116.666666666664,-5,-313000
2021,county,48439,Tarrant,11001,District of Columbia,DC,D.C.,81,4436000,54765.432098765436,63,2929000,46492.06349206349,18,1507000
2021,county,48113,Dallas,11001,District of Columbia,DC,D.C.,204,23454000,114970.58823529411,203,13368000,65852.21674876848,1,10086000
2021,county,48085,Collin,11001,District of Columbia,DC,D.C.,60,3983000,66383.33333333333,38,2048000,53894.73684210526,22,1935000
2021,county,48439,Tarrant,35013,Dona Ana,NM,Rural New Mexico,47,1331000,28319.14893617021,43,1258000,29255.81395348837,4,73000
2021,county,48113,Dallas,35013,Dona Ana,NM,Rural New Mexico,39,779000,19974.358974358973,61,1770000,29016.39344262295,-22,-991000
2021,county,48439,Tarrant,31055,Douglas,NE,Omaha,182,6961000,38247.25274725275,92,2707000,29423.91304347826,90,4254000
2021,county,48439,Tarrant,08035,Douglas,CO,Denver,172,16972000,98674.41860465116,157,9538000,60751.5923566879,15,7434000
2021,county,48113,Dallas,31055,Douglas,NE,Omaha,166,7254000,43698.79518072289,90,2854000,31711.11111111111,76,4400000
2021,county,48113,Dallas,08035,Douglas,CO,Denver,90,3821000,42455.555555555555,153,10434000,68196.07843137255,-63,-6613000
2021,county,48121,Denton,08035,Douglas,CO,Denver,175,9474000,54137.142857142855,126,6585000,52261.90476190476,49,2889000
2021,county,48085,Collin,08035,Douglas,CO,Denver,195,9955000,51051.282051282054,140,13921000,99435.71428571429,55,-3966000
2021,county,48085,Collin,31055,Douglas,NE,Omaha,111,6195000,55810.81081081081,40,1482000,37050.0,71,4713000
2021,county,48439,Tarrant,17043,DuPage,IL,Chicago,164,11341000,69152.43902439025,60,2925000,48750.0,104,8416000
2021,county,48113,Dallas,17043,DuPage,IL,Chicago,228,19364000,84929.82456140351,109,5975000,54816.51376146789,119,13389000
2021,county,48121,Denton,17043,DuPage,IL,Chicago,251,15484000,61689.24302788845,69,3051000,44217.391304347824,182,12433000
2021,county,48085,Collin,17043,DuPage,IL,Chicago,455,25383000,55786.81318681319,83,3457000,41650.60240963855,372,21926000
2021,county,48439,Tarrant,37063,Durham,NC,Raleigh,35,1292000,36914.28571428572,33,1856000,56242.42424242424,2,-564000
2021,county,48113,Dallas,37063,Durham,NC,Raleigh,78,4380000,56153.846153846156,75,4613000,61506.666666666664,3,-233000
2021,county,48439,Tarrant,12031,Duval,FL,Jacksonville,208,5917000,28447.115384615383,185,6831000,36924.32432432433,23,-914000
2021,county,48113,Dallas,12031,Duval,FL,Jacksonville,240,9554000,39808.333333333336,182,7684000,42219.78021978022,58,1870000
2021,county,48121,Denton,12031,Duval,FL,Jacksonville,81,6191000,76432.09876543209,88,2938000,33386.36363636364,-7,3253000
2021,county,48085,Collin,12031,Duval,FL,Jacksonville,145,7197000,49634.48275862069,70,3906000,55800.0,75,3291000
2021,county,48439,Tarrant,22033,East Baton Rouge Parish,LA,Rural Louisiana,179,4711000,26318.435754189944,114,1734000,15210.526315789473,65,2977000
2021,county,48113,Dallas,22033,East Baton Rouge Parish,LA,Rural Louisiana,256,6226000,24320.3125,117,3659000,31273.504273504273,139,2567000
2021,county,48121,Denton,22033,East Baton Rouge Parish,LA,Rural Louisiana,83,2767000,33337.34939759036,52,1290000,24807.69230769231,31,1477000
2021,county,48085,Collin,22033,East Baton Rouge Parish,LA,Rural Louisiana,108,4932000,45666.666666666664,62,2949000,47564.51612903226,46,1983000
2021,county,48439,Tarrant,48133,Eastland,TX,Rural Texas,37,888000,24000.0,99,3005000,30353.535353535353,-62,-2117000
2021,county,48439,Tarrant,48135,Ector,TX,Rural Texas,302,7878000,26086.09271523179,161,3097000,19236.024844720498,141,4781000
2021,county,48113,Dallas,48135,Ector,TX,Rural Texas,197,4155000,21091.370558375635,94,2733000,29074.468085106382,103,1422000
2021,county,48439,Tarrant,48141,El Paso,TX,El Paso,578,15270000,26418.685121107268,454,11007000,24244.493392070486,124,4263000
2021,county,48439,Tarrant,08041,El Paso,CO,Colorado Springs,333,11338000,34048.04804804805,442,15210000,34411.76470588235,-109,-3872000
2021,county,48113,Dallas,48141,El Paso,TX,El Paso,516,14718000,28523.25581395349,500,14264000,28528.0,16,454000
2021,county,48113,Dallas,08041,El Paso,CO,Colorado Springs,197,5762000,29248.730964467006,273,11076000,40571.42857142857,-76,-5314000
2021,county,48121,Denton,48141,El Paso,TX,El Paso,215,7486000,34818.604651162794,112,4280000,38214.28571428572,103,3206000
2021,county,48121,Denton,08041,El Paso,CO,Colorado Springs,154,5001000,32474.025974025975,179,6288000,35128.49162011173,-25,-1287000
2021,county,48085,Collin,48141,El Paso,TX,El Paso,227,7904000,34819.3832599119,164,5207000,31750.0,63,2697000
2021,county,48085,Collin,08041,El Paso,CO,Colorado Springs,157,5425000,34554.140127388535,191,8296000,43434.55497382199,-34,-2871000
2021,county,48439,Tarrant,48139,Ellis,TX,Dallas-Fort Worth,1330,40194000,30221.052631578947,3112,108021000,34711.11825192802,-1782,-67827000
2021,county,48113,Dallas,48139,Ellis,TX,Dallas-Fort Worth,2668,68121000,25532.608695652172,6755,193334000,28620.873427091043,-4087,-125213000
2021,county,48121,Denton,48139,Ellis,TX,Dallas-Fort Worth,286,9847000,34430.06993006993,511,21344000,41769.08023483366,-225,-11497000
2021,county,48085,Collin,48139,Ellis,TX,Dallas-Fort Worth,306,9409000,30748.366013071896,370,15946000,43097.2972972973,-64,-6537000
2021,county,48439,Tarrant,48143,Erath,TX,Rural Texas,197,5845000,29670.05076142132,267,9238000,34599.25093632959,-70,-3393000
2021,county,48113,Dallas,48143,Erath,TX,Rural Texas,46,928000,20173.91304347826,51,2257000,44254.901960784315,-5,-1329000
2021,county,48121,Denton,48143,Erath,TX,Rural Texas,41,553000,13487.80487804878,59,1868000,31661.01694915254,-18,-1315000
2021,county,48439,Tarrant,36029,Erie,NY,Buffalo,92,2805000,30489.130434782608,30,1059000,35300.0,62,1746000
2021,county,48113,Dallas,36029,Erie,NY,Buffalo,97,3709000,38237.113402061856,61,1605000,26311.475409836065,36,2104000
2021,county,48439,Tarrant,12033,Escambia,FL,FL Panhandle,83,2282000,27493.975903614457,67,2401000,35835.82089552239,16,-119000
2021,county,48113,Dallas,12033,Escambia,FL,FL Panhandle,56,2457000,43875.0,57,2652000,46526.31578947369,-1,-195000
2021,county,48121,Denton,12033,Escambia,FL,FL Panhandle,38,1695000,44605.26315789474,31,1947000,62806.45161290323,7,-252000
2021,county,48113,Dallas,34013,Essex,NJ,New York,113,8472000,74973.45132743364,53,1635000,30849.056603773584,60,6837000
2021,county,48113,Dallas,25009,Essex,MA,Boston,52,7382000,141961.53846153847,34,1840000,54117.64705882353,18,5542000
2021,county,48439,Tarrant,51059,Fairfax,VA,D.C.,222,12251000,55184.68468468468,138,6611000,47905.79710144927,84,5640000
2021,county,48113,Dallas,51059,Fairfax,VA,D.C.,292,23980000,82123.28767123287,200,10956000,54780.0,92,13024000
2021,county,48121,Denton,51059,Fairfax,VA,D.C.,232,14534000,62646.55172413793,96,4910000,51145.833333333336,136,9624000
2021,county,48085,Collin,51059,Fairfax,VA,D.C.,345,22843000,66211.59420289854,126,8262000,65571.42857142857,219,14581000
2021,county,48113,Dallas,09001,Fairfield,CT,New York,154,13191000,85655.84415584416,96,10293000,107218.75,58,2898000
2021,county,48439,Tarrant,48147,Fannin,TX,Rural Texas,49,2061000,42061.22448979592,106,3244000,30603.77358490566,-57,-1183000
2021,county,48113,Dallas,48147,Fannin,TX,Rural Texas,98,2683000,27377.551020408162,230,6388000,27773.91304347826,-132,-3705000
2021,county,48085,Collin,48147,Fannin,TX,Rural Texas,228,5675000,24890.35087719298,626,28570000,45638.97763578275,-398,-22895000
2021,county,48113,Dallas,05045,Faulkner,AR,Little Rock,37,1294000,34972.97297297297,33,942000,28545.454545454544,4,352000
2021,county,48439,Tarrant,21067,Fayette,KY,Lexington,31,1310000,42258.06451612903,36,1545000,42916.666666666664,-5,-235000
2021,county,48113,Dallas,21067,Fayette,KY,Lexington,43,1149000,26720.93023255814,44,3352000,76181.81818181818,-1,-2203000
2021,county,48113,Dallas,13117,Forsyth,GA,Atlanta,37,2557000,69108.1081081081,77,4287000,55675.32467532468,-40,-1730000
2021,county,48113,Dallas,37067,Forsyth,NC,Greensboro,32,1101000,34406.25,33,2282000,69151.51515151515,-1,-1181000
2021,county,48121,Denton,13117,Forsyth,GA,Atlanta,54,4188000,77555.55555555556,61,2752000,45114.75409836065,-7,1436000
2021,county,48085,Collin,13117,Forsyth,GA,Atlanta,60,3540000,59000.0,63,2485000,39444.444444444445,-3,1055000
2021,county,48439,Tarrant,48157,Fort Bend,TX,Houston,423,15940000,37683.215130023644,364,15282000,41983.51648351648,59,658000
2021,county,48113,Dallas,48157,Fort Bend,TX,Houston,376,17798000,47335.10638297872,432,17873000,41372.68518518518,-56,-75000
2021,county,48121,Denton,48157,Fort Bend,TX,Houston,331,17569000,53078.549848942595,259,10712000,41359.07335907336,72,6857000
2021,county,48085,Collin,48157,Fort Bend,TX,Houston,445,24187000,54352.808988764045,322,13525000,42003.105590062114,123,10662000
2021,county,48439,Tarrant,39049,Franklin,OH,Columbus,198,6536000,33010.10101010101,175,5131000,29320.0,23,1405000
2021,county,48113,Dallas,39049,Franklin,OH,Columbus,241,12392000,51419.08713692946,194,14737000,75963.9175257732,47,-2345000
2021,county,48121,Denton,39049,Franklin,OH,Columbus,128,6441000,50320.3125,54,1619000,29981.48148148148,74,4822000
2021,county,48085,Collin,39049,Franklin,OH,Columbus,200,8971000,44855.0,56,1894000,33821.42857142857,144,7077000
2021,county,48113,Dallas,48161,Freestone,TX,Rural Texas,53,1106000,20867.924528301886,93,2069000,22247.31182795699,-40,-963000
2021,county,48439,Tarrant,06019,Fresno,CA,Fresno,114,4261000,37377.19298245614,40,946000,23650.0,74,3315000
2021,county,48113,Dallas,06019,Fresno,CA,Fresno,85,3454000,40635.294117647056,60,1759000,29316.666666666668,25,1695000
2021,county,48439,Tarrant,13121,Fulton,GA,Atlanta,194,11575000,59664.948453608245,174,11655000,66982.75862068965,20,-80000
2021,county,48113,Dallas,13121,Fulton,GA,Atlanta,333,27236000,81789.7897897898,368,22882000,62179.34782608696,-35,4354000
2021,county,48121,Denton,13121,Fulton,GA,Atlanta,163,12086000,74147.23926380368,66,3350000,50757.57575757576,97,8736000
2021,county,48085,Collin,13121,Fulton,GA,Atlanta,235,13285000,56531.914893617024,166,9400000,56626.50602409639,69,3885000
2021,county,48439,Tarrant,48167,Galveston,TX,Houston,136,9455000,69522.05882352941,237,7847000,33109.70464135021,-101,1608000
2021,county,48113,Dallas,48167,Galveston,TX,Houston,173,6880000,39768.78612716763,211,8048000,38142.18009478673,-38,-1168000
2021,county,48121,Denton,48167,Galveston,TX,Houston,91,5954000,65428.57142857143,113,4908000,43433.62831858407,-22,1046000
2021,county,48085,Collin,48167,Galveston,TX,Houston,106,4182000,39452.83018867925,93,5874000,63161.290322580644,13,-1692000
2021,county,48113,Dallas,05051,Garland,AR,Rural Arkansas,27,851000,31518.51851851852,56,2199000,39267.857142857145,-29,-1348000
2021,county,48439,Tarrant,26049,Genesee,MI,Rural Michigan,109,1831000,16798.16513761468,66,1363000,20651.515151515152,43,468000
2021,county,48113,Dallas,26049,Genesee,MI,Rural Michigan,48,862000,17958.333333333332,39,946000,24256.410256410258,9,-84000
2021,county,48439,Tarrant,48181,Grayson,TX,Rural Texas,250,6052000,24208.0,387,12297000,31775.19379844961,-137,-6245000
2021,county,48113,Dallas,48181,Grayson,TX,Rural Texas,334,8507000,25470.05988023952,886,27876000,31462.7539503386,-552,-19369000
2021,county,48121,Denton,48181,Grayson,TX,Rural Texas,436,13657000,31323.394495412846,1135,49321000,43454.62555066079,-699,-35664000
2021,county,48085,Collin,48181,Grayson,TX,Rural Texas,1298,45210000,34830.50847457627,2855,112113000,39269.00175131349,-1557,-66903000
2021,county,48439,Tarrant,29077,Greene,MO,Rural Missouri,62,1880000,30322.58064516129,74,1997000,26986.486486486487,-12,-117000
2021,county,48113,Dallas,29077,Greene,MO,Rural Missouri,52,1176000,22615.384615384617,44,1209000,27477.272727272728,8,-33000
2021,county,48085,Collin,29077,Greene,MO,Rural Missouri,37,2122000,57351.35135135135,41,1452000,35414.634146341465,-4,670000
2021,county,48439,Tarrant,45045,Greenville,SC,Greenville,83,2794000,33662.65060240964,86,4182000,48627.90697674418,-3,-1388000
2021,county,48113,Dallas,45045,Greenville,SC,Greenville,53,6015000,113490.56603773584,59,3719000,63033.898305084746,-6,2296000
2021,county,48439,Tarrant,48183,Gregg,TX,Rural Texas,167,3243000,19419.161676646705,178,4903000,27544.94382022472,-11,-1660000
2021,county,48113,Dallas,48183,Gregg,TX,Rural Texas,314,7798000,24834.394904458597,309,8177000,26462.783171521034,5,-379000
2021,county,48121,Denton,48183,Gregg,TX,Rural Texas,133,3127000,23511.27819548872,99,3487000,35222.22222222222,34,-360000
2021,county,48085,Collin,48183,Gregg,TX,Rural Texas,118,3764000,31898.305084745763,76,2759000,36302.63157894737,42,1005000
2021,county,48439,Tarrant,48187,Guadalupe,TX,San Antonio,95,2662000,28021.052631578947,106,3312000,31245.283018867925,-11,-650000
2021,county,48113,Dallas,48187,Guadalupe,TX,San Antonio,86,3072000,35720.93023255814,80,2721000,34012.5,6,351000
2021,county,48121,Denton,48187,Guadalupe,TX,San Antonio,40,1868000,46700.0,73,2395000,32808.21917808219,-33,-527000
2021,county,48085,Collin,48187,Guadalupe,TX,San Antonio,68,2766000,40676.470588235294,73,2485000,34041.09589041096,-5,281000
2021,county,48113,Dallas,37081,Guilford,NC,Greensboro,77,2363000,30688.31168831169,35,1579000,45114.28571428572,42,784000
2021,county,48085,Collin,37081,Guilford,NC,Greensboro,47,2505000,53297.87234042553,35,1314000,37542.857142857145,12,1191000
2021,county,48439,Tarrant,13135,Gwinnett,GA,Atlanta,120,3992000,33266.666666666664,133,2851000,21436.09022556391,-13,1141000
2021,county,48113,Dallas,13135,Gwinnett,GA,Atlanta,191,4681000,24507.853403141362,154,4765000,30941.55844155844,37,-84000
2021,county,48121,Denton,13135,Gwinnett,GA,Atlanta,90,3970000,44111.11111111111,75,2246000,29946.666666666668,15,1724000
2021,county,48085,Collin,13135,Gwinnett,GA,Atlanta,118,3931000,33313.5593220339,120,4752000,39600.0,-2,-821000
2021,county,48439,Tarrant,39061,Hamilton,OH,Cincinnati,59,2179000,36932.20338983051,70,1956000,27942.85714285714,-11,223000
2021,county,48439,Tarrant,47065,Hamilton,TN,Chattanooga,39,1769000,45358.97435897436,47,1629000,34659.574468085106,-8,140000
2021,county,48439,Tarrant,18057,Hamilton,IN,Indianapolis,48,1914000,39875.0,63,3587000,56936.50793650794,-15,-1673000
2021,county,48113,Dallas,39061,Hamilton,OH,Cincinnati,97,5229000,53907.21649484536,82,5935000,72378.0487804878,15,-706000
2021,county,48113,Dallas,18057,Hamilton,IN,Indianapolis,67,3188000,47582.08955223881,55,4792000,87127.27272727272,12,-1604000
2021,county,48113,Dallas,47065,Hamilton,TN,Chattanooga,37,2028000,54810.81081081081,43,2181000,50720.93023255814,-6,-153000
2021,county,48439,Tarrant,48201,Harris,TX,Houston,2229,101057000,45337.3710183939,1969,76861000,39035.55104113763,260,24196000
2021,county,48113,Dallas,48201,Harris,TX,Houston,3323,151598000,45620.82455612398,2960,142237000,48053.04054054054,363,9361000
2021,county,48121,Denton,48201,Harris,TX,Houston,1167,52142000,44680.37703513282,831,31372000,37752.10589651023,336,20770000
2021,county,48085,Collin,48201,Harris,TX,Houston,1450,66300000,45724.137931034486,1069,46172000,43191.76800748363,381,20128000
2021,county,48439,Tarrant,48203,Harrison,TX,Rural Texas,82,1503000,18329.268292682926,90,2789000,30988.88888888889,-8,-1286000
2021,county,48439,Tarrant,28047,Harrison,MS,Gulfport-Biloxi,79,1149000,14544.303797468354,55,1740000,31636.363636363636,24,-591000
2021,county,48113,Dallas,48203,Harrison,TX,Rural Texas,113,2048000,18123.893805309734,149,2735000,18355.704697986577,-36,-687000
2021,county,48113,Dallas,28047,Harrison,MS,Gulfport-Biloxi,65,882000,13569.23076923077,51,921000,18058.823529411766,14,-39000
2021,county,48439,Tarrant,09003,Hartford,CT,Hartford,81,3762000,46444.444444444445,41,2107000,51390.243902439026,40,1655000
2021,county,48113,Dallas,09003,Hartford,CT,Hartford,105,4372000,41638.09523809524,61,3471000,56901.639344262294,44,901000
2021,county,48085,Collin,09003,Hartford,CT,Hartford,166,9067000,54620.48192771084,36,1013000,28138.88888888889,130,8054000
2021,county,48439,Tarrant,48209,Hays,TX,Austin,178,7488000,42067.41573033708,189,6911000,36566.137566137564,-11,577000
2021,county,48113,Dallas,48209,Hays,TX,Austin,204,6635000,32524.50980392157,214,12029000,56210.280373831774,-10,-5394000
2021,county,48121,Denton,48209,Hays,TX,Austin,119,5407000,45436.97478991596,110,5424000,49309.09090909091,9,-17000
2021,county,48085,Collin,48209,Hays,TX,Austin,135,4488000,33244.444444444445,142,8522000,60014.08450704225,-7,-4034000
2021,county,48439,Tarrant,48213,Henderson,TX,Rural Texas,159,5520000,34716.981132075474,348,15659000,44997.12643678161,-189,-10139000
2021,county,48113,Dallas,48213,Henderson,TX,Rural Texas,318,7522000,23654.088050314465,856,36680000,42850.46728971963,-538,-29158000
2021,county,48121,Denton,48213,Henderson,TX,Rural Texas,83,4077000,49120.48192771084,177,8965000,50649.71751412429,-94,-4888000
2021,county,48085,Collin,48213,Henderson,TX,Rural Texas,94,3800000,40425.53191489362,211,15235000,72203.79146919432,-117,-11435000
2021,county,48439,Tarrant,27053,Hennepin,MN,Minneapolis,198,9651000,48742.42424242424,133,4490000,33759.3984962406,65,5161000
2021,county,48113,Dallas,27053,Hennepin,MN,Minneapolis,345,16183000,46907.24637681159,166,8037000,48415.66265060241,179,8146000
2021,county,48121,Denton,27053,Hennepin,MN,Minneapolis,190,14597000,76826.31578947368,36,1963000,54527.77777777778,154,12634000
2021,county,48085,Collin,27053,Hennepin,MN,Minneapolis,285,15905000,55807.01754385965,108,6242000,57796.2962962963,177,9663000
2021,county,48113,Dallas,51087,Henrico,VA,Richmond,84,3813000,45392.857142857145,40,1692000,42300.0,44,2121000
2021,county,48113,Dallas,13151,Henry,GA,Atlanta,38,1225000,32236.842105263157,46,2019000,43891.30434782609,-8,-794000
2021,county,48439,Tarrant,48215,Hidalgo,TX,Rural Texas,215,7841000,36469.767441860466,206,6410000,31116.504854368934,9,1431000
2021,county,48113,Dallas,48215,Hidalgo,TX,Rural Texas,306,7177000,23454.24836601307,329,6732000,20462.006079027356,-23,445000
2021,county,48121,Denton,48215,Hidalgo,TX,Rural Texas,117,3282000,28051.28205128205,70,1972000,28171.428571428572,47,1310000
2021,county,48085,Collin,48215,Hidalgo,TX,Rural Texas,127,3613000,28448.818897637797,110,3404000,30945.454545454544,17,209000
2021,county,48439,Tarrant,48217,Hill,TX,Rural Texas,179,3701000,20675.977653631286,389,16946000,43562.98200514139,-210,-13245000
2021,county,48113,Dallas,48217,Hill,TX,Rural Texas,104,1653000,15894.23076923077,206,4551000,22092.233009708736,-102,-2898000
2021,county,48439,Tarrant,12057,Hillsborough,FL,Tampa,235,19733000,83970.21276595745,273,14077000,51564.10256410256,-38,5656000
2021,county,48439,Tarrant,33011,Hillsborough,NH,Rural New Hampshire,55,3255000,59181.818181818184,48,1901000,39604.166666666664,7,1354000
2021,county,48113,Dallas,12057,Hillsborough,FL,Tampa,315,13843000,43946.031746031746,350,19396000,55417.142857142855,-35,-5553000
2021,county,48121,Denton,12057,Hillsborough,FL,Tampa,114,5063000,44412.28070175439,146,6425000,44006.849315068495,-32,-1362000
2021,county,48085,Collin,12057,Hillsborough,FL,Tampa,214,8697000,40640.18691588785,202,9582000,47435.64356435643,12,-885000
2021,county,48439,Tarrant,28049,Hinds,MS,Jackson,295,3904000,13233.898305084746,86,1016000,11813.953488372093,209,2888000
2021,county,48113,Dallas,28049,Hinds,MS,Jackson,280,5106000,18235.714285714286,71,1965000,27676.056338028167,209,3141000
2021,county,48085,Collin,28049,Hinds,MS,Jackson,125,2154000,17232.0,48,961000,20020.833333333332,77,1193000
2021,county,48439,Tarrant,15003,Honolulu,HI,Rural Hawaii,235,6320000,26893.617021276597,109,4565000,41880.733944954125,126,1755000
2021,county,48113,Dallas,15003,Honolulu,HI,Rural Hawaii,127,5156000,40598.425196850396,99,3419000,34535.35353535353,28,1737000
2021,county,48121,Denton,15003,Honolulu,HI,Rural Hawaii,150,4483000,29886.666666666668,46,1463000,31804.347826086956,104,3020000
2021,county,48085,Collin,15003,Honolulu,HI,Rural Hawaii,205,7559000,36873.170731707316,68,3066000,45088.23529411765,137,4493000
2021,county,48439,Tarrant,48221,Hood,TX,Rural Texas,685,28909000,42202.9197080292,1343,62595000,46608.33953834698,-658,-33686000
2021,county,48113,Dallas,48221,Hood,TX,Rural Texas,102,2592000,25411.764705882353,233,11516000,49424.892703862664,-131,-8924000
2021,county,48121,Denton,48221,Hood,TX,Rural Texas,93,5384000,57892.47311827957,164,10941000,66713.41463414633,-71,-5557000
2021,county,48085,Collin,48221,Hood,TX,Rural Texas,50,1881000,37620.0,99,7069000,71404.04040404041,-49,-5188000
2021,county,48439,Tarrant,48223,Hopkins,TX,Rural Texas,46,1425000,30978.260869565216,51,1830000,35882.35294117647,-5,-405000
2021,county,48113,Dallas,48223,Hopkins,TX,Rural Texas,98,2038000,20795.918367346938,224,5734000,25598.214285714286,-126,-3696000
2021,county,48085,Collin,48223,Hopkins,TX,Rural Texas,60,1656000,27600.0,101,3587000,35514.851485148516,-41,-1931000
2021,county,48113,Dallas,24027,Howard,MD,Baltimore,97,4966000,51195.87628865979,40,1719000,42975.0,57,3247000
2021,county,48439,Tarrant,34017,Hudson,NJ,New York,154,5335000,34642.857142857145,33,1137000,34454.545454545456,121,4198000
2021,county,48113,Dallas,34017,Hudson,NJ,New York,255,19237000,75439.2156862745,115,6392000,55582.608695652176,140,12845000
2021,county,48085,Collin,34017,Hudson,NJ,New York,235,15383000,65459.574468085106,56,3036000,54214.28571428572,179,12347000
2021,county,48439,Tarrant,48231,Hunt,TX,Dallas-Fort Worth,203,5148000,25359.60591133005,323,8409000,26034.05572755418,-120,-3261000
2021,county,48113,Dallas,48231,Hunt,TX,Dallas-Fort Worth,829,22832000,27541.6164053076,2247,51783000,23045.39385847797,-1418,-28951000
2021,county,48121,Denton,48231,Hunt,TX,Dallas-Fort Worth,114,3561000,31236.842105263157,316,9316000,29481.01265822785,-202,-5755000
2021,county,48085,Collin,48231,Hunt,TX,Dallas-Fort Worth,765,21230000,27751.633986928104,1318,39690000,30113.80880121396,-553,-18460000
2021,county,48439,Tarrant,48237,Jack,TX,Rural Texas,40,921000,23025.0,92,3138000,34108.69565217391,-52,-2217000
2021,county,48439,Tarrant,29095,Jackson,MO,Kansas City,283,5838000,20628.975265017667,163,4377000,26852.76073619632,120,1461000
2021,county,48113,Dallas,29095,Jackson,MO,Kansas City,240,10480000,43666.666666666664,185,6371000,34437.83783783784,55,4109000
2021,county,48121,Denton,29095,Jackson,MO,Kansas City,143,4037000,28230.76923076923,53,1759000,33188.67924528302,90,2278000
2021,county,48085,Collin,29095,Jackson,MO,Kansas City,120,4373000,36441.666666666664,52,2077000,39942.307692307695,68,2296000
2021,county,48439,Tarrant,48245,Jefferson,TX,Rural Texas,169,5983000,35402.36686390533,99,2782000,28101.010101010103,70,3201000
2021,county,48439,Tarrant,08059,Jefferson,CO,Denver,151,7634000,50556.291390728475,110,7443000,67663.63636363637,41,191000
2021,county,48439,Tarrant,01073,Jefferson,AL,Birmingham,88,2962000,33659.09090909091,72,1682000,23361.11111111111,16,1280000
2021,county,48439,Tarrant,21111,Jefferson,KY,Louisville,99,2488000,25131.31313131313,108,2895000,26805.555555555555,-9,-407000
2021,county,48439,Tarrant,05069,Jefferson,AR,Rural Arkansas,58,743000,12810.344827586207,54,580000,10740.74074074074,4,163000
2021,county,48113,Dallas,48245,Jefferson,TX,Rural Texas,200,5469000,27345.0,134,2543000,18977.611940298506,66,2926000
2021,county,48113,Dallas,01073,Jefferson,AL,Birmingham,142,6272000,44169.01408450704,115,5541000,48182.608695652176,27,731000
2021,county,48113,Dallas,08059,Jefferson,CO,Denver,106,6248000,58943.3962264151,204,12701000,62259.80392156863,-98,-6453000
2021,county,48113,Dallas,21111,Jefferson,KY,Louisville,119,6130000,51512.60504201681,113,5745000,50840.70796460177,6,385000
2021,county,48113,Dallas,05069,Jefferson,AR,Rural Arkansas,81,1552000,19160.493827160495,45,475000,10555.555555555555,36,1077000
2021,county,48121,Denton,08059,Jefferson,CO,Denver,103,5119000,49699.029126213594,90,5111000,56788.88888888889,13,8000
2021,county,48121,Denton,21111,Jefferson,KY,Louisville,86,3196000,37162.79069767442,48,2517000,52437.5,38,679000
2021,county,48121,Denton,48245,Jefferson,TX,Rural Texas,56,2944000,52571.42857142857,40,1414000,35350.0,16,1530000
2021,county,48085,Collin,08059,Jefferson,CO,Denver,101,5720000,56633.66336633663,121,8685000,71776.85950413223,-20,-2965000
2021,county,48085,Collin,48245,Jefferson,TX,Rural Texas,54,2513000,46537.03703703704,35,1127000,32200.0,19,1386000
2021,county,48439,Tarrant,22051,Jefferson Parish,LA,New Orleans,148,2803000,18939.18918918919,48,1390000,28958.333333333332,100,1413000
2021,county,48113,Dallas,22051,Jefferson Parish,LA,New Orleans,205,4310000,21024.39024390244,86,2206000,25651.162790697676,119,2104000
2021,county,48085,Collin,22051,Jefferson Parish,LA,New Orleans,135,3546000,26266.666666666668,45,1782000,39600.0,90,1764000
2021,county,48439,Tarrant,48251,Johnson,TX,Dallas-Fort Worth,4084,100698000,24656.709108716943,8286,260151000,31396.451846488053,-4202,-159453000
2021,county,48439,Tarrant,20091,Johnson,KS,Kansas City,127,7345000,57834.64566929134,116,7150000,61637.93103448276,11,195000
2021,county,48113,Dallas,48251,Johnson,TX,Dallas-Fort Worth,402,9997000,24868.1592039801,1344,41776000,31083.333333333332,-942,-31779000
2021,county,48113,Dallas,20091,Johnson,KS,Kansas City,256,9880000,38593.75,160,10085000,63031.25,96,-205000
2021,county,48121,Denton,48251,Johnson,TX,Dallas-Fort Worth,203,5937000,29246.30541871921,244,10106000,41418.03278688525,-41,-4169000
2021,county,48121,Denton,20091,Johnson,KS,Kansas City,153,10456000,68339.86928104576,104,4807000,46221.153846153844,49,5649000
2021,county,48085,Collin,20091,Johnson,KS,Kansas City,303,22033000,72716.17161716172,123,7198000,58520.32520325203,180,14835000
2021,county,48085,Collin,48251,Johnson,TX,Dallas-Fort Worth,69,1863000,27000.0,156,6479000,41532.05128205128,-87,-4616000
2021,county,48439,Tarrant,48257,Kaufman,TX,Dallas-Fort Worth,450,13983000,31073.333333333332,972,29470000,30318.930041152264,-522,-15487000
2021,county,48113,Dallas,48257,Kaufman,TX,Dallas-Fort Worth,3018,74064000,24540.755467196817,10790,268760000,24908.248378127897,-7772,-194696000
2021,county,48121,Denton,48257,Kaufman,TX,Dallas-Fort Worth,321,9906000,30859.81308411215,738,24539000,33250.67750677507,-417,-14633000
2021,county,48085,Collin,48257,Kaufman,TX,Dallas-Fort Worth,580,20084000,34627.58620689655,968,32503000,33577.479338842975,-388,-12419000
2021,county,48113,Dallas,48259,Kendall,TX,Rural Texas,32,1436000,44875.0,46,3221000,70021.73913043478,-14,-1785000
2021,county,48439,Tarrant,26081,Kent,MI,Rural Michigan,78,1767000,22653.846153846152,71,2677000,37704.22535211268,7,-910000
2021,county,48113,Dallas,26081,Kent,MI,Rural Michigan,94,3156000,33574.46808510638,49,3656000,74612.24489795919,45,-500000
2021,county,48439,Tarrant,06029,Kern,CA,Rural California,154,5049000,32785.71428571428,48,1451000,30229.166666666668,106,3598000
2021,county,48113,Dallas,06029,Kern,CA,Rural California,111,3346000,30144.144144144146,37,1077000,29108.108108108107,74,2269000
2021,county,48113,Dallas,48265,Kerr,TX,Rural Texas,40,2155000,53875.0,41,3185000,77682.9268292683,-1,-1030000
2021,county,48439,Tarrant,53033,King,WA,Seattle,451,28331000,62818.181818181816,277,13004000,46945.84837545126,174,15327000
2021,county,48113,Dallas,53033,King,WA,Seattle,582,88290000,151701.03092783506,619,43760000,70694.66882067852,-37,44530000
2021,county,48121,Denton,53033,King,WA,Seattle,529,37914000,71671.0775047259,213,14155000,66455.39906103286,316,23759000
2021,county,48085,Collin,53033,King,WA,Seattle,838,62418000,74484.48687350836,449,44193000,98425.38975501113,389,18225000
2021,county,48439,Tarrant,36047,Kings,NY,New York,181,6399000,35353.591160220996,88,3078000,34977.27272727273,93,3321000
2021,county,48113,Dallas,36047,Kings,NY,New York,337,23839000,70738.87240356083,168,8989000,53505.95238095238,169,14850000
2021,county,48121,Denton,36047,Kings,NY,New York,109,5064000,46458.71559633027,47,1920000,40851.063829787236,62,3144000
2021,county,48085,Collin,36047,Kings,NY,New York,245,13365000,54551.02040816326,72,3712000,51555.555555555555,173,9653000
2021,county,48439,Tarrant,53035,Kitsap,WA,Rural Washington,51,1641000,32176.470588235294,40,1222000,30550.0,11,419000
2021,county,48113,Dallas,53035,Kitsap,WA,Rural Washington,40,1341000,33525.0,49,1632000,33306.12244897959,-9,-291000
2021,county,48439,Tarrant,47093,Knox,TN,Knoxville,48,941000,19604.166666666668,97,3776000,38927.83505154639,-49,-2835000
2021,county,48113,Dallas,47093,Knox,TN,Knoxville,63,2394000,38000.0,77,5214000,67714.28571428571,-14,-2820000
2021,county,48439,Tarrant,22055,Lafayette Parish,LA,Rural Louisiana,84,2691000,32035.714285714286,60,1718000,28633.333333333332,24,973000
2021,county,48113,Dallas,22055,Lafayette Parish,LA,Rural Louisiana,106,3155000,29764.150943396227,85,3150000,37058.82352941176,21,5000
2021,county,48439,Tarrant,18089,Lake,IN,Rural Indiana,109,2093000,19201.83486238532,59,1314000,22271.186440677968,50,779000
2021,county,48113,Dallas,17097,Lake,IL,Chicago,135,11011000,81562.96296296296,68,4105000,60367.64705882353,67,6906000
2021,county,48113,Dallas,12069,Lake,FL,Orlando,33,972000,29454.545454545456,43,1621000,37697.67441860465,-10,-649000
2021,county,48121,Denton,17097,Lake,IL,Chicago,155,10890000,70258.06451612903,35,1625000,46428.57142857143,120,9265000
2021,county,48085,Collin,17097,Lake,IL,Chicago,281,18570000,66085.40925266904,58,2495000,43017.24137931035,223,16075000
2021,county,48439,Tarrant,48277,Lamar,TX,Rural Texas,95,2076000,21852.63157894737,113,3507000,31035.398230088496,-18,-1431000
2021,county,48113,Dallas,48277,Lamar,TX,Rural Texas,95,2055000,21631.57894736842,163,4347000,26668.71165644172,-68,-2292000
2021,county,48085,Collin,48277,Lamar,TX,Rural Texas,74,3500000,47297.2972972973,107,3286000,30710.280373831774,-33,214000
2021,county,48439,Tarrant,31109,Lancaster,NE,Rural Nebraska,58,1884000,32482.758620689656,49,1268000,25877.551020408162,9,616000
2021,county,48113,Dallas,41039,Lane,OR,Rural Oregon,34,1364000,40117.64705882353,42,1800000,42857.142857142855,-8,-436000
2021,county,48439,Tarrant,08069,Larimer,CO,Rural Colorado,82,5182000,63195.12195121951,81,3536000,43654.32098765432,1,1646000
2021,county,48113,Dallas,08069,Larimer,CO,Rural Colorado,47,1773000,37723.40425531915,119,7699000,64697.47899159664,-72,-5926000
2021,county,48121,Denton,08069,Larimer,CO,Rural Colorado,61,2063000,33819.67213114754,66,3818000,57848.48484848485,-5,-1755000
2021,county,48085,Collin,08069,Larimer,CO,Rural Colorado,52,2471000,47519.230769230766,59,2052000,34779.661016949154,-7,419000
2021,county,48439,Tarrant,12071,Lee,FL,S.W. Florida,98,3098000,31612.244897959183,121,6732000,55636.36363636364,-23,-3634000
2021,county,48113,Dallas,12071,Lee,FL,S.W. Florida,90,2995000,33277.77777777778,121,14423000,119198.34710743802,-31,-11428000
2021,county,48121,Denton,12071,Lee,FL,S.W. Florida,57,2967000,52052.63157894737,61,3357000,55032.7868852459,-4,-390000
2021,county,48085,Collin,12071,Lee,FL,S.W. Florida,40,1473000,36825.0,72,3953000,54902.77777777778,-32,-2480000
2021,county,48113,Dallas,12073,Leon,FL,Rural Florida,58,2706000,46655.1724137931,38,1031000,27131.57894736842,20,1675000
2021,county,48113,Dallas,48293,Limestone,TX,Rural Texas,47,842000,17914.893617021276,68,1066000,15676.470588235294,-21,-224000
2021,county,48113,Dallas,22061,Lincoln Parish,LA,Rural Louisiana,68,2348000,34529.41176470588,45,692000,15377.777777777777,23,1656000
2021,county,48439,Tarrant,19113,Linn,IA,Rural Iowa,50,2454000,49080.0,26,922000,35461.53846153846,24,1532000
2021,county,48439,Tarrant,06037,Los Angeles,CA,Los Angeles,2022,119120000,58911.96834817013,602,22243000,36948.5049833887,1420,96877000
2021,county,48113,Dallas,06037,Los Angeles,CA,Los Angeles,2142,236087000,110218.02054154995,945,61825000,65423.28042328043,1197,174262000
2021,county,48121,Denton,06037,Los Angeles,CA,Los Angeles,1302,75024000,57622.1198156682,300,15940000,53133.333333333336,1002,59084000
2021,county,48085,Collin,06037,Los Angeles,CA,Los Angeles,2171,109945000,50642.56103178259,477,22609000,47398.32285115304,1694,87336000
2021,county,48439,Tarrant,51107,Loudoun,VA,Rural Virginia,94,3936000,41872.34042553192,54,5002000,92629.62962962964,40,-1066000
2021,county,48113,Dallas,51107,Loudoun,VA,Rural Virginia,85,4940000,58117.64705882353,52,3036000,58384.61538461538,33,1904000
2021,county,48085,Collin,51107,Loudoun,VA,Rural Virginia,183,9474000,51770.49180327869,79,3886000,49189.873417721516,104,5588000
2021,county,48439,Tarrant,48303,Lubbock,TX,Rural Texas,582,19704000,33855.67010309279,435,12646000,29071.264367816093,147,7058000
2021,county,48113,Dallas,48303,Lubbock,TX,Rural Texas,458,17928000,39144.10480349345,328,9353000,28515.243902439026,130,8575000
2021,county,48121,Denton,48303,Lubbock,TX,Rural Texas,250,7839000,31356.0,175,5689000,32508.571428571428,75,2150000
2021,county,48085,Collin,48303,Lubbock,TX,Rural Texas,250,11625000,46500.0,169,10572000,62556.21301775148,81,1053000
2021,county,48439,Tarrant,26099,Macomb,MI,Rural Michigan,108,3028000,28037.037037037036,80,2414000,30175.0,28,614000
2021,county,48113,Dallas,26099,Macomb,MI,Rural Michigan,52,1924000,37000.0,44,1318000,29954.545454545456,8,606000
2021,county,48439,Tarrant,01089,Madison,AL,Huntsville,76,4739000,62355.26315789474,86,2900000,33720.93023255814,-10,1839000
2021,county,48439,Tarrant,28089,Madison,MS,Jackson,67,1356000,20238.805970149253,57,2182000,38280.70175438596,10,-826000
2021,county,48113,Dallas,01089,Madison,AL,Huntsville,71,2441000,34380.281690140844,47,2356000,50127.65957446808,24,85000
2021,county,48113,Dallas,28089,Madison,MS,Jackson,59,1531000,25949.15254237288,36,1882000,52277.77777777778,23,-351000
2021,county,48113,Dallas,12081,Manatee,FL,Rural Florida,42,1971000,46928.57142857143,58,6539000,112741.37931034483,-16,-4568000
2021,county,48439,Tarrant,04013,Maricopa,AZ,Phoenix,954,54309000,56927.67295597484,735,39238000,53385.034013605444,219,15071000
2021,county,48113,Dallas,04013,Maricopa,AZ,Phoenix,1005,80927000,80524.37810945274,807,49998000,61955.39033457249,198,30929000
2021,county,48121,Denton,04013,Maricopa,AZ,Phoenix,625,37528000,60044.8,430,22689000,52765.11627906977,195,14839000
2021,county,48085,Collin,04013,Maricopa,AZ,Phoenix,769,32777000,42622.88686605982,431,24350000,56496.51972157773,338,8427000
2021,county,48439,Tarrant,18097,Marion,IN,Indianapolis,160,5417000,33856.25,135,2907000,21533.333333333332,25,2510000
2021,county,48113,Dallas,18097,Marion,IN,Indianapolis,219,7013000,32022.83105022831,123,3876000,31512.19512195122,96,3137000
2021,county,48121,Denton,18097,Marion,IN,Indianapolis,53,1905000,35943.3962264151,63,1264000,20063.492063492064,-10,641000
2021,county,48085,Collin,18097,Marion,IN,Indianapolis,88,2141000,24329.545454545456,29,2307000,79551.72413793103,59,-166000
2021,county,48439,Tarrant,48309,McLennan,TX,Rural Texas,567,15879000,28005.291005291005,440,11868000,26972.727272727272,127,4011000
2021,county,48113,Dallas,48309,McLennan,TX,Rural Texas,436,10365000,23772.935779816515,499,14695000,29448.897795591183,-63,-4330000
2021,county,48121,Denton,48309,McLennan,TX,Rural Texas,181,4553000,25154.696132596684,191,9498000,49727.74869109948,-10,-4945000
2021,county,48085,Collin,48309,McLennan,TX,Rural Texas,156,4824000,30923.076923076922,172,6792000,39488.37209302326,-16,-1968000
2021,county,48439,Tarrant,37119,Mecklenburg,NC,Charlotte,129,8205000,63604.651162790695,155,7045000,45451.6129032258,-26,1160000
2021,county,48113,Dallas,37119,Mecklenburg,NC,Charlotte,282,18668000,66198.58156028368,284,15040000,52957.74647887324,-2,3628000
2021,county,48121,Denton,37119,Mecklenburg,NC,Charlotte,99,4674000,47212.121212121216,72,6223000,86430.55555555556,27,-1549000
2021,county,48085,Collin,37119,Mecklenburg,NC,Charlotte,258,15125000,58624.03100775194,145,8406000,57972.41379310345,113,6719000
2021,county,48113,Dallas,34021,Mercer,NJ,Rural New Jersey,54,1947000,36055.555555555555,45,1397000,31044.444444444445,9,550000
2021,county,48439,Tarrant,12086,Miami-Dade,FL,Miami,333,9456000,28396.396396396398,176,5705000,32414.772727272728,157,3751000
2021,county,48113,Dallas,12086,Miami-Dade,FL,Miami,505,23886000,47299.0099009901,372,26076000,70096.7741935484,133,-2190000
2021,county,48121,Denton,12086,Miami-Dade,FL,Miami,233,7621000,32708.154506437768,115,5132000,44626.086956521736,118,2489000
2021,county,48085,Collin,12086,Miami-Dade,FL,Miami,255,8599000,33721.56862745098,114,4236000,37157.89473684211,141,4363000
2021,county,48439,Tarrant,25017,Middlesex,MA,Boston,156,9616000,61641.02564102564,73,3068000,42027.397260273974,83,6548000
2021,county,48113,Dallas,25017,Middlesex,MA,Boston,215,17035000,79232.55813953489,160,9308000,58175.0,55,7727000
2021,county,48113,Dallas,34023,Middlesex,NJ,New York,282,12607000,44705.67375886525,76,3686000,48500.0,206,8921000
2021,county,48121,Denton,25017,Middlesex,MA,Boston,121,8643000,71429.7520661157,63,2536000,40253.968253968254,58,6107000
2021,county,48085,Collin,34023,Middlesex,NJ,New York,591,29802000,50426.395939086295,78,3277000,42012.820512820515,513,26525000
2021,county,48085,Collin,25017,Middlesex,MA,Boston,236,14325000,60699.15254237288,126,9855000,78214.28571428571,110,4470000
2021,county,48439,Tarrant,48329,Midland,TX,Rural Texas,418,21240000,50813.397129186604,254,9199000,36216.535433070865,164,12041000
2021,county,48113,Dallas,48329,Midland,TX,Rural Texas,337,29551000,87688.42729970327,211,8039000,38099.526066350714,126,21512000
2021,county,48121,Denton,48329,Midland,TX,Rural Texas,163,6301000,38656.44171779141,66,3097000,46924.242424242424,97,3204000
2021,county,48085,Collin,48329,Midland,TX,Rural Texas,204,7754000,38009.80392156863,81,2905000,35864.1975308642,123,4849000
2021,county,48113,Dallas,05091,Miller,AR,Rural Arkansas,35,719000,20542.85714285714,42,548000,13047.619047619048,-7,171000
2021,county,48439,Tarrant,55079,Milwaukee,WI,Milwaukee,232,4613000,19883.620689655174,112,3026000,27017.85714285714,120,1587000
2021,county,48113,Dallas,55079,Milwaukee,WI,Milwaukee,270,6592000,24414.814814814814,153,4082000,26679.738562091505,117,2510000
2021,county,48085,Collin,55079,Milwaukee,WI,Milwaukee,144,4468000,31027.777777777777,42,3491000,83119.04761904762,102,977000
2021,county,48439,Tarrant,01097,Mobile,AL,Mobile,85,1736000,20423.529411764706,52,1167000,22442.30769230769,33,569000
2021,county,48113,Dallas,01097,Mobile,AL,Mobile,79,1947000,24645.569620253165,34,764000,22470.58823529412,45,1183000
2021,county,48113,Dallas,36055,Monroe,NY,Rochester,84,1937000,23059.52380952381,56,1768000,31571.428571428572,28,169000
2021,county,48439,Tarrant,48337,Montague,TX,Rural Texas,63,1685000,26746.031746031746,208,7992000,38423.07692307692,-145,-6307000
2021,county,48113,Dallas,48337,Montague,TX,Rural Texas,43,1567000,36441.86046511628,48,1869000,38937.5,-5,-302000
2021,county,48121,Denton,48337,Montague,TX,Rural Texas,97,2173000,22402.061855670105,222,7518000,33864.86486486487,-125,-5345000
2021,county,48439,Tarrant,48339,Montgomery,TX,Houston,405,23800000,58765.432098765436,477,20493000,42962.264150943396,-72,3307000
2021,county,48439,Tarrant,24031,Montgomery,MD,D.C.,116,4889000,42146.55172413793,85,5709000,67164.70588235294,31,-820000
2021,county,48439,Tarrant,47125,Montgomery,TN,Rural Tennessee,77,2258000,29324.675324675325,36,1231000,34194.444444444445,41,1027000
2021,county,48439,Tarrant,39113,Montgomery,OH,Rural Ohio,79,2302000,29139.240506329115,59,1582000,26813.5593220339,20,720000
2021,county,48113,Dallas,48339,Montgomery,TX,Houston,381,21068000,55296.587926509186,431,32196000,74700.69605568446,-50,-11128000
2021,county,48113,Dallas,24031,Montgomery,MD,D.C.,183,11119000,60759.56284153005,168,13383000,79660.71428571429,15,-2264000
2021,county,48113,Dallas,39113,Montgomery,OH,Rural Ohio,63,2825000,44841.269841269845,55,1104000,20072.727272727272,8,1721000
2021,county,48113,Dallas,42091,Montgomery,PA,Philadelphia,78,4276000,54820.51282051282,84,5094000,60642.857142857145,-6,-818000
2021,county,48113,Dallas,47125,Montgomery,TN,Rural Tennessee,32,563000,17593.75,63,1498000,23777.777777777777,-31,-935000
2021,county,48121,Denton,48339,Montgomery,TX,Houston,275,17862000,64952.72727272727,286,12123000,42388.11188811189,-11,5739000
2021,county,48121,Denton,24031,Montgomery,MD,D.C.,97,4663000,48072.16494845361,43,1013000,23558.13953488372,54,3650000
2021,county,48085,Collin,48339,Montgomery,TX,Houston,334,16606000,49718.5628742515,339,16194000,47769.91150442478,-5,412000
2021,county,48085,Collin,24031,Montgomery,MD,D.C.,139,8191000,58928.05755395684,76,3320000,43684.21052631579,63,4871000
2021,county,48439,Tarrant,41051,Multnomah,OR,Portland,83,3757000,45265.06024096385,78,2568000,32923.07692307692,5,1189000
2021,county,48113,Dallas,41051,Multnomah,OR,Portland,157,9591000,61089.171974522294,114,5211000,45710.52631578947,43,4380000
2021,county,48121,Denton,41051,Multnomah,OR,Portland,75,2469000,32920.0,41,2096000,51121.95121951219,34,373000
2021,county,48085,Collin,41051,Multnomah,OR,Portland,69,2984000,43246.3768115942,35,1324000,37828.57142857143,34,1660000
2021,county,48439,Tarrant,48347,Nacogdoches,TX,Rural Texas,66,1620000,24545.454545454544,50,1463000,29260.0,16,157000
2021,county,48113,Dallas,48347,Nacogdoches,TX,Rural Texas,103,3421000,33213.59223300971,83,2156000,25975.90361445783,20,1265000
2021,county,48113,Dallas,36059,Nassau,NY,New York,131,6189000,47244.274809160306,56,3963000,70767.85714285714,75,2226000
2021,county,48085,Collin,36059,Nassau,NY,New York,198,8567000,43267.67676767677,35,1445000,41285.71428571428,163,7122000
2021,county,48439,Tarrant,48349,Navarro,TX,Rural Texas,142,3242000,22830.985915492958,224,9182000,40991.07142857143,-82,-5940000
2021,county,48113,Dallas,48349,Navarro,TX,Rural Texas,269,5289000,19661.710037174722,661,16653000,25193.645990922843,-392,-11364000
2021,county,48121,Denton,48349,Navarro,TX,Rural Texas,50,1069000,21380.0,66,3692000,55939.393939393936,-16,-2623000
2021,county,48085,Collin,48349,Navarro,TX,Rural Texas,42,1421000,33833.333333333336,88,4910000,55795.454545454544,-46,-3489000
2021,county,48439,Tarrant,10003,New Castle,DE,Rural Delaware,59,2120000,35932.20338983051,50,1161000,23220.0,9,959000
2021,county,48113,Dallas,10003,New Castle,DE,Rural Delaware,79,4348000,55037.9746835443,38,1560000,41052.63157894737,41,2788000
2021,county,48113,Dallas,09009,New Haven,CT,New Haven,80,3325000,41562.5,35,3124000,89257.14285714286,45,201000
2021,county,48439,Tarrant,36061,New York,NY,New York,171,13251000,77491.22807017544,80,5352000,66900.0,91,7899000
2021,county,48113,Dallas,36061,New York,NY,New York,651,143715000,220760.36866359448,328,32091000,97838.41463414633,323,111624000
2021,county,48121,Denton,36061,New York,NY,New York,135,11566000,85674.07407407407,62,4173000,67306.45161290323,73,7393000
2021,county,48085,Collin,36061,New York,NY,New York,199,19960000,100301.50753768845,92,7005000,76141.30434782608,107,12955000
2021,county,48113,Dallas,25021,Norfolk,MA,Boston,104,9280000,89230.76923076923,55,6023000,109509.09090909091,49,3257000
2021,county,48439,Tarrant,51710,Norfolk city,VA,Hampton Roads,64,1431000,22359.375,38,1156000,30421.052631578947,26,275000
2021,county,48113,Dallas,51710,Norfolk city,VA,Hampton Roads,42,1235000,29404.761904761905,38,1416000,37263.15789473684,4,-181000
2021,county,48439,Tarrant,48355,Nueces,TX,Rural Texas,248,8910000,35927.41935483871,195,7647000,39215.38461538462,53,1263000
2021,county,48113,Dallas,48355,Nueces,TX,Rural Texas,212,8673000,40910.377358490565,201,8269000,41139.30348258706,11,404000
2021,county,48121,Denton,48355,Nueces,TX,Rural Texas,114,3926000,34438.59649122807,97,3558000,36680.41237113402,17,368000
2021,county,48085,Collin,48355,Nueces,TX,Rural Texas,89,2874000,32292.134831460673,86,3368000,39162.79069767442,3,-494000
2021,county,48439,Tarrant,26125,Oakland,MI,Detroit,121,5965000,49297.520661157025,73,3145000,43082.191780821915,48,2820000
2021,county,48113,Dallas,26125,Oakland,MI,Detroit,186,13329000,71661.29032258065,125,9249000,73992.0,61,4080000
2021,county,48121,Denton,26125,Oakland,MI,Detroit,152,9282000,61065.78947368421,55,2663000,48418.181818181816,97,6619000
2021,county,48085,Collin,26125,Oakland,MI,Detroit,323,22027000,68195.04643962848,102,3812000,37372.549019607846,221,18215000
2021,county,48439,Tarrant,12091,Okaloosa,FL,FL Panhandle,62,1821000,29370.967741935485,63,2524000,40063.49206349206,-1,-703000
2021,county,48439,Tarrant,40109,Oklahoma,OK,Oklahoma City,467,16146000,34573.875802997856,497,15013000,30207.24346076459,-30,1133000
2021,county,48113,Dallas,40109,Oklahoma,OK,Oklahoma City,573,24902000,43458.98778359511,519,20960000,40385.35645472062,54,3942000
2021,county,48121,Denton,40109,Oklahoma,OK,Oklahoma City,321,13526000,42137.071651090344,193,6543000,33901.55440414508,128,6983000
2021,county,48085,Collin,40109,Oklahoma,OK,Oklahoma City,301,13867000,46069.767441860466,269,10883000,40457.24907063197,32,2984000
2021,county,48439,Tarrant,36067,Onondaga,NY,Rural New York,47,1273000,27085.106382978724,39,1635000,41923.07692307692,8,-362000
2021,county,48439,Tarrant,37133,Onslow,NC,Rural North Carolina,137,2283000,16664.233576642335,59,1110000,18813.5593220339,78,1173000
2021,county,48439,Tarrant,06059,Orange,CA,Los Angeles,815,47785000,58631.9018404908,243,7262000,29884.77366255144,572,40523000
2021,county,48439,Tarrant,12095,Orange,FL,Orlando,251,8513000,33916.33466135458,251,12022000,47896.41434262948,0,-3509000
2021,county,48113,Dallas,06059,Orange,CA,Los Angeles,792,75352000,95141.41414141415,365,38450000,105342.46575342465,427,36902000
2021,county,48113,Dallas,12095,Orange,FL,Orlando,292,10568000,36191.78082191781,267,15324000,57393.25842696629,25,-4756000
2021,county,48121,Denton,06059,Orange,CA,Los Angeles,848,66501000,78420.99056603774,191,11981000,62727.74869109948,657,54520000
2021,county,48121,Denton,12095,Orange,FL,Orlando,173,5966000,34485.54913294798,120,5102000,42516.666666666664,53,864000
2021,county,48085,Collin,06059,Orange,CA,Los Angeles,1310,166970000,127458.01526717558,284,14247000,50165.49295774648,1026,152723000
2021,county,48085,Collin,12095,Orange,FL,Orlando,170,5384000,31670.58823529412,166,7295000,43945.78313253012,4,-1911000
2021,county,48439,Tarrant,22071,Orleans Parish,LA,New Orleans,166,3396000,20457.831325301206,81,2676000,33037.03703703704,85,720000
2021,county,48113,Dallas,22071,Orleans Parish,LA,New Orleans,264,8208000,31090.909090909092,165,7910000,47939.393939393936,99,298000
2021,county,48439,Tarrant,12097,Osceola,FL,Orlando,96,1719000,17906.25,89,2338000,26269.662921348314,7,-619000
2021,county,48113,Dallas,12097,Osceola,FL,Orlando,43,1158000,26930.232558139534,69,3161000,45811.59420289855,-26,-2003000
2021,county,48439,Tarrant,22073,Ouachita Parish,LA,Rural Louisiana,300,3892000,12973.333333333334,112,1404000,12535.714285714286,188,2488000
2021,county,48113,Dallas,22073,Ouachita Parish,LA,Rural Louisiana,401,5100000,12718.204488778056,123,2785000,22642.27642276423,278,2315000
2021,county,48085,Collin,22073,Ouachita Parish,LA,Rural Louisiana,122,3506000,28737.70491803279,47,888000,18893.617021276597,75,2618000
2021,county,48439,Tarrant,12099,Palm Beach,FL,Miami,99,4054000,40949.49494949495,179,10840000,60558.659217877095,-80,-6786000
2021,county,48113,Dallas,12099,Palm Beach,FL,Miami,235,11540000,49106.382978723406,207,14074000,67990.33816425121,28,-2534000
2021,county,48121,Denton,12099,Palm Beach,FL,Miami,107,5132000,47962.6168224299,75,5702000,76026.66666666667,32,-570000
2021,county,48085,Collin,12099,Palm Beach,FL,Miami,169,7615000,45059.17159763313,126,7457000,59182.53968253968,43,158000
2021,county,48439,Tarrant,48363,Palo Pinto,TX,Rural Texas,153,3809000,24895.42483660131,349,12671000,36306.59025787966,-196,-8862000
2021,county,48113,Dallas,48363,Palo Pinto,TX,Rural Texas,33,926000,28060.60606060606,65,3744000,57600.0,-32,-2818000
2021,county,48439,Tarrant,48367,Parker,TX,Dallas-Fort Worth,2923,107361000,36729.72972972973,6665,278632000,41805.25131282821,-3742,-171271000
2021,county,48113,Dallas,48367,Parker,TX,Dallas-Fort Worth,166,6107000,36789.156626506025,452,19870000,43960.176991150445,-286,-13763000
2021,county,48121,Denton,48367,Parker,TX,Dallas-Fort Worth,244,9262000,37959.016393442624,512,24089000,47048.828125,-268,-14827000
2021,county,48085,Collin,48367,Parker,TX,Dallas-Fort Worth,74,2225000,30067.567567567567,188,7509000,39941.48936170213,-114,-5284000
2021,county,48439,Tarrant,12101,Pasco,FL,Tampa,37,1201000,32459.45945945946,80,2801000,35012.5,-43,-1600000
2021,county,48113,Dallas,12101,Pasco,FL,Tampa,42,2029000,48309.52380952381,74,5487000,74148.64864864865,-32,-3458000
2021,county,48439,Tarrant,40119,Payne,OK,Rural Oklahoma,39,967000,24794.871794871793,43,2104000,48930.232558139534,-4,-1137000
2021,county,48439,Tarrant,42101,Philadelphia,PA,Philadelphia,79,2831000,35835.443037974685,59,2025000,34322.03389830508,20,806000
2021,county,48113,Dallas,42101,Philadelphia,PA,Philadelphia,193,12882000,66746.1139896373,108,6358000,58870.37037037037,85,6524000
2021,county,48085,Collin,42101,Philadelphia,PA,Philadelphia,71,3745000,52746.47887323944,32,1248000,39000.0,39,2497000
2021,county,48439,Tarrant,53053,Pierce,WA,Seattle,318,10783000,33908.80503144654,144,4418000,30680.555555555555,174,6365000
2021,county,48113,Dallas,53053,Pierce,WA,Seattle,158,5231000,33107.59493670886,124,4569000,36846.77419354839,34,662000
2021,county,48121,Denton,53053,Pierce,WA,Seattle,167,7642000,45760.479041916165,69,2177000,31550.72463768116,98,5465000
2021,county,48085,Collin,53053,Pierce,WA,Seattle,228,8420000,36929.82456140351,48,1960000,40833.333333333336,180,6460000
2021,county,48439,Tarrant,04019,Pima,AZ,Tucson,208,9378000,45086.53846153846,158,6869000,43474.6835443038,50,2509000
2021,county,48113,Dallas,04019,Pima,AZ,Tucson,166,7143000,43030.12048192771,122,9893000,81090.16393442624,44,-2750000
2021,county,48121,Denton,04019,Pima,AZ,Tucson,89,3988000,44808.988764044945,74,2447000,33067.56756756757,15,1541000
2021,county,48085,Collin,04019,Pima,AZ,Tucson,184,8171000,44407.608695652176,79,4188000,53012.6582278481,105,3983000
2021,county,48439,Tarrant,04021,Pinal,AZ,Phoenix,75,2361000,31480.0,73,3211000,43986.30136986302,2,-850000
2021,county,48113,Dallas,04021,Pinal,AZ,Phoenix,42,1969000,46880.95238095238,42,1148000,27333.333333333332,0,821000
2021,county,48439,Tarrant,12103,Pinellas,FL,Tampa,91,6217000,68318.68131868132,110,4549000,41354.545454545456,-19,1668000
2021,county,48113,Dallas,12103,Pinellas,FL,Tampa,103,4359000,42320.388349514564,174,11126000,63942.528735632186,-71,-6767000
2021,county,48121,Denton,12103,Pinellas,FL,Tampa,72,3951000,54875.0,101,6799000,67316.83168316832,-29,-2848000
2021,county,48085,Collin,12103,Pinellas,FL,Tampa,93,4059000,43645.16129032258,96,5777000,60177.083333333336,-3,-1718000
2021,county,48439,Tarrant,19153,Polk,IA,Rural Iowa,80,1713000,21412.5,86,1561000,18151.162790697676,-6,152000
2021,county,48439,Tarrant,12105,Polk,FL,Orlando,81,2215000,27345.679012345678,114,3611000,31675.43859649123,-33,-1396000
2021,county,48113,Dallas,19153,Polk,IA,Rural Iowa,111,4614000,41567.56756756757,110,2145000,19500.0,1,2469000
2021,county,48113,Dallas,12105,Polk,FL,Orlando,72,2013000,27958.333333333332,109,2776000,25467.889908256882,-37,-763000
2021,county,48121,Denton,12105,Polk,FL,Orlando,49,1023000,20877.551020408162,65,2182000,33569.230769230766,-16,-1159000
2021,county,48085,Collin,12105,Polk,FL,Orlando,71,1669000,23507.042253521126,47,2013000,42829.78723404255,24,-344000
2021,county,48085,Collin,19153,Polk,IA,Rural Iowa,45,1818000,40400.0,31,1014000,32709.677419354837,14,804000
2021,county,48439,Tarrant,48375,Potter,TX,Rural Texas,135,3445000,25518.51851851852,95,2202000,23178.947368421053,40,1243000
2021,county,48113,Dallas,48375,Potter,TX,Rural Texas,117,3047000,26042.735042735043,113,1694000,14991.150442477876,4,1353000
2021,county,48121,Denton,48375,Potter,TX,Rural Texas,60,2079000,34650.0,42,1429000,34023.80952380953,18,650000
2021,county,48085,Collin,48375,Potter,TX,Rural Texas,108,3933000,36416.666666666664,34,1040000,30588.235294117647,74,2893000
2021,county,48439,Tarrant,24033,Prince George,MD,Rural Maryland,108,4104000,38000.0,63,1900000,30158.73015873016,45,2204000
2021,county,48113,Dallas,24033,Prince George,MD,Rural Maryland,185,5782000,31254.054054054053,104,2863000,27528.846153846152,81,2919000
2021,county,48439,Tarrant,51153,Prince William,VA,Rural Virginia,116,3754000,32362.068965517243,67,2234000,33343.28358208955,49,1520000
2021,county,48113,Dallas,51153,Prince William,VA,Rural Virginia,76,3551000,46723.68421052631,46,1301000,28282.608695652172,30,2250000
2021,county,48113,Dallas,44007,Providence,RI,Providence,58,5231000,90189.6551724138,37,1358000,36702.7027027027,21,3873000
2021,county,48439,Tarrant,05119,Pulaski,AR,Little Rock,335,5756000,17182.089552238805,142,3363000,23683.098591549297,193,2393000
2021,county,48113,Dallas,05119,Pulaski,AR,Little Rock,414,16845000,40688.40579710145,222,9679000,43599.0990990991,192,7166000
2021,county,48121,Denton,05119,Pulaski,AR,Little Rock,193,4642000,24051.81347150259,76,3307000,43513.15789473684,117,1335000
2021,county,48085,Collin,05119,Pulaski,AR,Little Rock,165,5198000,31503.030303030304,82,4143000,50524.39024390244,83,1055000
2021,county,48439,Tarrant,36081,Queens,NY,New York,350,9122000,26062.85714285714,50,1771000,35420.0,300,7351000
2021,county,48113,Dallas,36081,Queens,NY,New York,365,15695000,43000.0,112,4610000,41160.71428571428,253,11085000
2021,county,48085,Collin,36081,Queens,NY,New York,327,15230000,46574.92354740061,51,1420000,27843.13725490196,276,13810000
2021,county,48113,Dallas,48379,Rains,TX,Rural Texas,39,1017000,26076.923076923078,100,4383000,43830.0,-61,-3366000
2021,county,48439,Tarrant,27123,Ramsey,MN,Minneapolis,46,1289000,28021.739130434784,51,1095000,21470.58823529412,-5,194000
2021,county,48113,Dallas,27123,Ramsey,MN,Minneapolis,68,2633000,38720.58823529412,72,1643000,22819.444444444445,-4,990000
2021,county,48439,Tarrant,48381,Randall,TX,Rural Texas,204,5571000,27308.823529411766,166,5654000,34060.24096385542,38,-83000
2021,county,48113,Dallas,48381,Randall,TX,Rural Texas,153,5768000,37699.34640522876,90,4143000,46033.333333333336,63,1625000
2021,county,48121,Denton,48381,Randall,TX,Rural Texas,133,4253000,31977.443609022557,77,2285000,29675.324675324675,56,1968000
2021,county,48085,Collin,48381,Randall,TX,Rural Texas,116,5787000,49887.93103448276,59,2116000,35864.40677966102,57,3671000
2021,county,48439,Tarrant,22079,Rapides Parish,LA,Rural Louisiana,126,2424000,19238.095238095237,48,996000,20750.0,78,1428000
2021,county,48113,Dallas,22079,Rapides Parish,LA,Rural Louisiana,94,1446000,15382.978723404256,56,1223000,21839.285714285714,38,223000
2021,county,48439,Tarrant,45079,Richland,SC,Columbia,50,1288000,25760.0,47,1296000,27574.468085106382,3,-8000
2021,county,48113,Dallas,45079,Richland,SC,Columbia,64,4050000,63281.25,42,1500000,35714.28571428572,22,2550000
2021,county,48439,Tarrant,06065,Riverside,CA,San Bernardino-Riverside,762,25550000,33530.18372703412,173,4612000,26658.959537572253,589,20938000
2021,county,48113,Dallas,06065,Riverside,CA,San Bernardino-Riverside,312,10647000,34125.0,207,7665000,37028.985507246376,105,2982000
2021,county,48121,Denton,06065,Riverside,CA,San Bernardino-Riverside,430,19175000,44593.023255813954,99,3687000,37242.42424242424,331,15488000
2021,county,48085,Collin,06065,Riverside,CA,San Bernardino-Riverside,577,19650000,34055.459272097054,105,4292000,40876.19047619047,472,15358000
2021,county,48439,Tarrant,48397,Rockwall,TX,Dallas-Fort Worth,258,11642000,45124.03100775194,374,19808000,52962.566844919784,-116,-8166000
2021,county,48113,Dallas,48397,Rockwall,TX,Dallas-Fort Worth,1864,88040000,47231.75965665236,4754,171647000,36105.80563735801,-2890,-83607000
2021,county,48121,Denton,48397,Rockwall,TX,Dallas-Fort Worth,188,13248000,70468.08510638298,462,16689000,36123.37662337662,-274,-3441000
2021,county,48085,Collin,48397,Rockwall,TX,Dallas-Fort Worth,1162,45794000,39409.638554216865,1466,68047000,46416.78035470669,-304,-22253000
2021,county,48439,Tarrant,48401,Rusk,TX,Rural Texas,54,491000,9092.592592592593,84,1736000,20666.666666666668,-30,-1245000
2021,county,48113,Dallas,48401,Rusk,TX,Rural Texas,91,1685000,18516.483516483517,91,2036000,22373.626373626375,0,-351000
2021,county,48439,Tarrant,47149,Rutherford,TN,Nashville,65,1529000,23523.076923076922,44,1756000,39909.09090909091,21,-227000
2021,county,48113,Dallas,47149,Rutherford,TN,Nashville,56,1533000,27375.0,40,877000,21925.0,16,656000
2021,county,48439,Tarrant,06067,Sacramento,CA,Sacramento,364,8803000,24184.065934065933,85,2569000,30223.529411764706,279,6234000
2021,county,48113,Dallas,06067,Sacramento,CA,Sacramento,260,9877000,37988.46153846154,117,4874000,41658.11965811966,143,5003000
2021,county,48121,Denton,06067,Sacramento,CA,Sacramento,157,7799000,49675.15923566879,57,2061000,36157.89473684211,100,5738000
2021,county,48085,Collin,06067,Sacramento,CA,Sacramento,198,7737000,39075.757575757576,69,3428000,49681.159420289856,129,4309000
2021,county,48439,Tarrant,05125,Saline,AR,Little Rock,43,934000,21720.93023255814,56,2098000,37464.28571428572,-13,-1164000
2021,county,48085,Collin,05125,Saline,AR,Little Rock,56,1736000,31000.0,54,2769000,51277.77777777778,2,-1033000
2021,county,48439,Tarrant,49035,Salt Lake,UT,Salt Lake,155,4489000,28961.290322580644,180,8578000,47655.555555555555,-25,-4089000
2021,county,48113,Dallas,49035,Salt Lake,UT,Salt Lake,239,10983000,45953.97489539749,183,10132000,55366.120218579235,56,851000
2021,county,48121,Denton,49035,Salt Lake,UT,Salt Lake,123,9236000,75089.43089430894,112,4882000,43589.28571428572,11,4354000
2021,county,48085,Collin,49035,Salt Lake,UT,Salt Lake,218,9705000,44518.34862385321,171,7147000,41795.3216374269,47,2558000
2021,county,48439,Tarrant,06071,San Bernardino,CA,San Bernardino-Riverside,647,18365000,28384.85316846986,170,3935000,23147.058823529413,477,14430000
2021,county,48113,Dallas,06071,San Bernardino,CA,San Bernardino-Riverside,240,10546000,43941.666666666664,151,3507000,23225.165562913906,89,7039000
2021,county,48121,Denton,06071,San Bernardino,CA,San Bernardino-Riverside,270,13337000,49396.2962962963,62,1340000,21612.90322580645,208,11997000
2021,county,48085,Collin,06071,San Bernardino,CA,San Bernardino-Riverside,374,11940000,31925.13368983957,79,2118000,26810.12658227848,295,9822000
2021,county,48439,Tarrant,06073,San Diego,CA,San Diego,1073,42027000,39167.75396085741,405,28030000,69209.87654320987,668,13997000
2021,county,48113,Dallas,06073,San Diego,CA,San Diego,762,47564000,62419.94750656168,551,26182000,47517.24137931035,211,21382000
2021,county,48121,Denton,06073,San Diego,CA,San Diego,576,29959000,52012.15277777778,182,9556000,52505.494505494506,394,20403000
2021,county,48085,Collin,06073,San Diego,CA,San Diego,753,37852000,50268.260292164676,242,13631000,56326.44628099174,511,24221000
2021,county,48439,Tarrant,06075,San Francisco,CA,Bay Area,80,8599000,107487.5,37,2572000,69513.51351351352,43,6027000
2021,county,48113,Dallas,06075,San Francisco,CA,Bay Area,255,63501000,249023.5294117647,130,12714000,97800.0,125,50787000
2021,county,48121,Denton,06075,San Francisco,CA,Bay Area,63,7654000,121492.06349206349,27,3110000,115185.18518518518,36,4544000
2021,county,48085,Collin,06075,San Francisco,CA,Bay Area,139,18027000,129690.64748201439,37,4630000,125135.13513513513,102,13397000
2021,county,48113,Dallas,06077,San Joaquin,CA,Bay Area,87,2166000,24896.55172413793,32,983000,30718.75,55,1183000
2021,county,48439,Tarrant,06081,San Mateo,CA,Bay Area,125,22828000,182624.0,60,2941000,49016.666666666664,65,19887000
2021,county,48113,Dallas,06081,San Mateo,CA,Bay Area,141,25290000,179361.70212765958,62,5587000,90112.90322580645,79,19703000
2021,county,48085,Collin,06081,San Mateo,CA,Bay Area,176,15427000,87653.40909090909,36,2160000,60000.0,140,13267000
2021,county,48439,Tarrant,06083,Santa Barbara,CA,Rural California,82,3711000,45256.09756097561,39,1243000,31871.79487179487,43,2468000
2021,county,48439,Tarrant,06085,Santa Clara,CA,Bay Area,334,22757000,68134.73053892216,141,7743000,54914.89361702128,193,15014000
2021,county,48113,Dallas,06085,Santa Clara,CA,Bay Area,556,53441000,96116.90647482015,214,14790000,69112.14953271027,342,38651000
2021,county,48121,Denton,06085,Santa Clara,CA,Bay Area,323,27946000,86520.12383900929,102,6625000,64950.98039215686,221,21321000
2021,county,48085,Collin,06085,Santa Clara,CA,Bay Area,826,71998000,87164.64891041162,231,15917000,68904.76190476191,595,56081000
2021,county,48439,Tarrant,35049,Santa Fe,NM,Rural New Mexico,44,1489000,33840.90909090909,39,3236000,82974.35897435897,5,-1747000
2021,county,48113,Dallas,35049,Santa Fe,NM,Rural New Mexico,43,7315000,170116.27906976745,83,7722000,93036.14457831325,-40,-407000
2021,county,48439,Tarrant,12113,Santa Rosa,FL,FL Panhandle,67,3519000,52522.388059701494,49,2283000,46591.836734693876,18,1236000
2021,county,48113,Dallas,12115,Sarasota,FL,S.W. Florida,45,2037000,45266.666666666664,80,10192000,127400.0,-35,-8155000
2021,county,48439,Tarrant,20173,Sedgwick,KS,Rural Kansas,222,7552000,34018.01801801802,169,6307000,37319.52662721893,53,1245000
2021,county,48113,Dallas,20173,Sedgwick,KS,Rural Kansas,216,6777000,31375.0,133,3411000,25646.61654135338,83,3366000
2021,county,48121,Denton,20173,Sedgwick,KS,Rural Kansas,129,3988000,30914.728682170542,51,1882000,36901.96078431373,78,2106000
2021,county,48085,Collin,20173,Sedgwick,KS,Rural Kansas,130,3851000,29623.076923076922,59,2772000,46983.05084745763,71,1079000
2021,county,48439,Tarrant,12117,Seminole,FL,Orlando,61,2788000,45704.91803278688,53,1973000,37226.41509433962,8,815000
2021,county,48113,Dallas,12117,Seminole,FL,Orlando,68,2862000,42088.23529411765,81,3041000,37543.20987654321,-13,-179000
2021,county,48085,Collin,12117,Seminole,FL,Orlando,65,3208000,49353.846153846156,48,2362000,49208.333333333336,17,846000
2021,county,48439,Tarrant,47157,Shelby,TN,Memphis,448,10710000,23906.25,213,4501000,21131.455399061033,235,6209000
2021,county,48113,Dallas,47157,Shelby,TN,Memphis,530,16874000,31837.735849056604,213,6595000,30962.44131455399,317,10279000
2021,county,48121,Denton,47157,Shelby,TN,Memphis,249,7998000,32120.481927710844,100,2704000,27040.0,149,5294000
2021,county,48085,Collin,47157,Shelby,TN,Memphis,245,8943000,36502.04081632653,90,2861000,31788.88888888889,155,6082000
2021,county,48439,Tarrant,48423,Smith,TX,Rural Texas,417,12303000,29503.59712230216,512,16216000,31671.875,-95,-3913000
2021,county,48113,Dallas,48423,Smith,TX,Rural Texas,632,13388000,21183.54430379747,751,28460000,37896.13848202397,-119,-15072000
2021,county,48121,Denton,48423,Smith,TX,Rural Texas,235,10212000,43455.31914893617,281,12591000,44807.829181494664,-46,-2379000
2021,county,48085,Collin,48423,Smith,TX,Rural Texas,325,11888000,36578.46153846154,367,20169000,54956.40326975477,-42,-8281000
2021,county,48439,Tarrant,53061,Snohomish,WA,Seattle,211,8375000,39691.943127962084,136,3979000,29257.352941176472,75,4396000
2021,county,48113,Dallas,53061,Snohomish,WA,Seattle,109,4605000,42247.706422018346,97,5277000,54402.0618556701,12,-672000
2021,county,48121,Denton,53061,Snohomish,WA,Seattle,177,8009000,45248.58757062147,39,2442000,62615.38461538462,138,5567000
2021,county,48085,Collin,53061,Snohomish,WA,Seattle,268,13858000,51708.9552238806,80,3761000,47012.5,188,10097000
2021,county,48113,Dallas,06095,Solano,CA,Bay Area,75,2601000,34680.0,34,1369000,40264.705882352944,41,1232000
2021,county,48113,Dallas,34035,Somerset,NJ,New York,64,4342000,67843.75,43,2000000,46511.62790697674,21,2342000
2021,county,48439,Tarrant,48425,Somervell,TX,Rural Texas,31,1274000,41096.77419354839,157,9411000,59942.67515923567,-126,-8137000
2021,county,48439,Tarrant,53063,Spokane,WA,Spokane,71,1967000,27704.225352112677,39,1737000,44538.46153846154,32,230000
2021,county,48085,Collin,53063,Spokane,WA,Spokane,44,1791000,40704.545454545456,38,1514000,39842.10526315789,6,277000
2021,county,48439,Tarrant,29183,St. Charles,MO,St. Louis,54,1996000,36962.96296296296,74,2296000,31027.027027027027,-20,-300000
2021,county,48113,Dallas,29183,St. Charles,MO,St. Louis,47,1942000,41319.14893617021,50,2337000,46740.0,-3,-395000
2021,county,48121,Denton,29183,St. Charles,MO,St. Louis,62,3636000,58645.16129032258,40,2292000,57300.0,22,1344000
2021,county,48439,Tarrant,17163,St. Clair,IL,St. Louis,58,1492000,25724.137931034482,39,986000,25282.05128205128,19,506000
2021,county,48439,Tarrant,12109,St. Johns,FL,Jacksonville,43,3325000,77325.58139534884,72,2687000,37319.444444444445,-29,638000
2021,county,48439,Tarrant,29189,St. Louis,MO,St. Louis,286,7341000,25667.832167832166,138,3387000,24543.478260869564,148,3954000
2021,county,48113,Dallas,29189,St. Louis,MO,St. Louis,315,14457000,45895.23809523809,210,15436000,73504.76190476191,105,-979000
2021,county,48121,Denton,29189,St. Louis,MO,St. Louis,249,10143000,40734.93975903615,66,4727000,71621.21212121213,183,5416000
2021,county,48085,Collin,29189,St. Louis,MO,St. Louis,309,13094000,42375.40453074434,101,4962000,49128.71287128713,208,8132000
2021,county,48439,Tarrant,29510,St. Louis city,MO,Rural Missouri,84,2029000,24154.761904761905,39,1153000,29564.102564102563,45,876000
2021,county,48113,Dallas,29510,St. Louis city,MO,Rural Missouri,133,4815000,36203.00751879699,100,3774000,37740.0,33,1041000
2021,county,48085,Collin,29510,St. Louis city,MO,Rural Missouri,55,1589000,28890.909090909092,33,846000,25636.363636363636,22,743000
2021,county,48439,Tarrant,22103,St. Tammany Parish,LA,New Orleans,64,1836000,28687.5,45,2046000,45466.666666666664,19,-210000
2021,county,48113,Dallas,22103,St. Tammany Parish,LA,New Orleans,45,3181000,70688.88888888889,46,2123000,46152.17391304348,-1,1058000
2021,county,48113,Dallas,06099,Stanislaus,CA,Bay Area,41,1459000,35585.365853658535,40,1095000,27375.0,1,364000
2021,county,48439,Tarrant,25025,Suffolk,MA,Boston,49,2484000,50693.87755102041,44,1792000,40727.27272727273,5,692000
2021,county,48113,Dallas,25025,Suffolk,MA,Boston,207,19931000,96285.02415458937,110,8709000,79172.72727272728,97,11222000
2021,county,48113,Dallas,36103,Suffolk,NY,New York,140,5537000,39550.0,52,2768000,53230.769230769234,88,2769000
2021,county,48113,Dallas,39153,Summit,OH,Rural Ohio,48,1327000,27645.833333333332,38,1853000,48763.15789473684,10,-526000
2021,county,48113,Dallas,48439,Tarrant,TX,Dallas-Fort Worth,19402,693542000,35745.90248427997,25364,796745000,31412.434947169215,-5962,-103203000
2021,county,48121,Denton,48439,Tarrant,TX,Dallas-Fort Worth,10884,544871000,50061.65012862918,7828,361152000,46135.922330097084,3056,183719000
2021,county,48085,Collin,48439,Tarrant,TX,Dallas-Fort Worth,3691,145520000,39425.629910593336,2789,107682000,38609.537468626746,902,37838000
2021,county,48439,Tarrant,48441,Taylor,TX,Rural Texas,428,9970000,23294.392523364488,331,8281000,25018.12688821752,97,1689000
2021,county,48113,Dallas,48441,Taylor,TX,Rural Texas,184,4527000,24603.260869565216,170,4895000,28794.117647058825,14,-368000
2021,county,48121,Denton,48441,Taylor,TX,Rural Texas,134,4989000,37231.34328358209,120,3785000,31541.666666666668,14,1204000
2021,county,48085,Collin,48441,Taylor,TX,Rural Texas,112,4563000,40741.07142857143,93,4247000,45666.666666666664,19,316000
2021,county,48439,Tarrant,53067,Thurston,WA,Rural Washington,76,1823000,23986.842105263157,39,1321000,33871.794871794875,37,502000
2021,county,48113,Dallas,48449,Titus,TX,Rural Texas,66,1222000,18515.151515151516,59,1294000,21932.20338983051,7,-72000
2021,county,48439,Tarrant,48451,Tom Green,TX,Rural Texas,156,4280000,27435.897435897437,153,3526000,23045.75163398693,3,754000
2021,county,48113,Dallas,48451,Tom Green,TX,Rural Texas,98,3173000,32377.551020408162,92,2174000,23630.434782608696,6,999000
2021,county,48121,Denton,48451,Tom Green,TX,Rural Texas,64,1016000,15875.0,67,1916000,28597.014925373136,-3,-900000
2021,county,48085,Collin,48451,Tom Green,TX,Rural Texas,52,1033000,19865.384615384617,50,1825000,36500.0,2,-792000
2021,county,48439,Tarrant,48453,Travis,TX,Austin,1274,136805000,107382.26059654632,1109,57152000,51534.71596032462,165,79653000
2021,county,48113,Dallas,48453,Travis,TX,Austin,1913,113497000,59329.32566649242,2200,155555000,70706.81818181818,-287,-42058000
2021,county,48121,Denton,48453,Travis,TX,Austin,641,33867000,52834.633385335415,627,36202000,57738.437001594895,14,-2335000
2021,county,48085,Collin,48453,Travis,TX,Austin,961,47092000,49003.12174817898,924,56024000,60632.03463203463,37,-8932000
2021,county,48439,Tarrant,40143,Tulsa,OK,Tulsa,421,13335000,31674.58432304038,371,13333000,35938.00539083558,50,2000
2021,county,48113,Dallas,40143,Tulsa,OK,Tulsa,388,20324000,52381.44329896907,355,13548000,38163.380281690144,33,6776000
2021,county,48121,Denton,40143,Tulsa,OK,Tulsa,150,5837000,38913.333333333336,153,5812000,37986.92810457516,-3,25000
2021,county,48085,Collin,40143,Tulsa,OK,Tulsa,300,12263000,40876.666666666664,231,10102000,43731.60173160173,69,2161000
2021,county,48113,Dallas,48459,Upshur,TX,Rural Texas,61,971000,15918.032786885246,61,1673000,27426.22950819672,0,-702000
2021,county,48439,Tarrant,49049,Utah,UT,Rural Utah,148,4338000,29310.81081081081,121,3291000,27198.347107438018,27,1047000
2021,county,48113,Dallas,49049,Utah,UT,Rural Utah,99,2680000,27070.70707070707,136,5624000,41352.94117647059,-37,-2944000
2021,county,48121,Denton,49049,Utah,UT,Rural Utah,123,2521000,20495.934959349594,71,2457000,34605.633802816905,52,64000
2021,county,48085,Collin,49049,Utah,UT,Rural Utah,141,4126000,29262.41134751773,139,3859000,27762.589928057554,2,267000
2021,county,48439,Tarrant,48465,Val Verde,TX,Rural Texas,43,776000,18046.511627906977,63,1034000,16412.698412698413,-20,-258000
2021,county,48439,Tarrant,48467,Van Zandt,TX,Rural Texas,99,2564000,25898.989898989897,211,7739000,36677.72511848341,-112,-5175000
2021,county,48113,Dallas,48467,Van Zandt,TX,Rural Texas,259,7277000,28096.525096525096,667,21045000,31551.724137931036,-408,-13768000
2021,county,48121,Denton,48467,Van Zandt,TX,Rural Texas,38,1702000,44789.47368421053,104,4139000,39798.07692307692,-66,-2437000
2021,county,48085,Collin,48467,Van Zandt,TX,Rural Texas,68,1792000,26352.941176470587,128,5704000,44562.5,-60,-3912000
2021,county,48439,Tarrant,06111,Ventura,CA,Los Angeles,246,12369000,50280.48780487805,72,2584000,35888.88888888889,174,9785000
2021,county,48113,Dallas,06111,Ventura,CA,Los Angeles,182,10873000,59741.758241758245,75,2122000,28293.333333333332,107,8751000
2021,county,48439,Tarrant,48469,Victoria,TX,Rural Texas,45,1687000,37488.88888888889,45,1438000,31955.555555555555,0,249000
2021,county,48113,Dallas,48469,Victoria,TX,Rural Texas,48,1393000,29020.833333333332,39,878000,22512.82051282051,9,515000
2021,county,48439,Tarrant,51810,Virginia Beach city,VA,Hampton Roads,111,3992000,35963.963963963964,82,2421000,29524.39024390244,29,1571000
2021,county,48113,Dallas,51810,Virginia Beach city,VA,Hampton Roads,110,3122000,28381.81818181818,74,2858000,38621.62162162162,36,264000
2021,county,48439,Tarrant,12127,Volusia,FL,Atlantic Coast,45,1040000,23111.11111111111,63,2686000,42634.920634920636,-18,-1646000
2021,county,48113,Dallas,12127,Volusia,FL,Atlantic Coast,36,2070000,57500.0,43,2034000,47302.32558139535,-7,36000
2021,county,48121,Denton,12127,Volusia,FL,Atlantic Coast,56,1824000,32571.428571428572,46,2637000,57326.086956521736,10,-813000
2021,county,48085,Collin,12127,Volusia,FL,Atlantic Coast,40,1528000,38200.0,41,2570000,62682.92682926829,-1,-1042000
2021,county,48439,Tarrant,37183,Wake,NC,Raleigh,132,5373000,40704.545454545456,114,6588000,57789.47368421053,18,-1215000
2021,county,48113,Dallas,37183,Wake,NC,Raleigh,218,11091000,50876.14678899082,220,13729000,62404.545454545456,-2,-2638000
2021,county,48121,Denton,37183,Wake,NC,Raleigh,84,4176000,49714.28571428572,113,4907000,43424.77876106195,-29,-731000
2021,county,48085,Collin,37183,Wake,NC,Raleigh,183,9758000,53322.4043715847,166,7958000,47939.75903614458,17,1800000
2021,county,48439,Tarrant,48471,Walker,TX,Rural Texas,55,1210000,22000.0,99,1116000,11272.727272727272,-44,94000
2021,county,48113,Dallas,48471,Walker,TX,Rural Texas,61,869000,14245.901639344262,122,1447000,11860.655737704918,-61,-578000
2021,county,48439,Tarrant,41067,Washington,OR,Portland,124,4169000,33620.967741935485,72,2637000,36625.0,52,1532000
2021,county,48439,Tarrant,05143,Washington,AR,Rural Arkansas,73,2315000,31712.328767123287,104,4120000,39615.38461538462,-31,-1805000
2021,county,48113,Dallas,05143,Washington,AR,Rural Arkansas,131,6484000,49496.18320610687,117,6986000,59709.40170940171,14,-502000
2021,county,48113,Dallas,41067,Washington,OR,Portland,133,7565000,56879.6992481203,94,4484000,47702.12765957447,39,3081000
2021,county,48121,Denton,41067,Washington,OR,Portland,125,8521000,68168.0,54,1625000,30092.59259259259,71,6896000
2021,county,48121,Denton,05143,Washington,AR,Rural Arkansas,52,2383000,45826.92307692308,44,1809000,41113.63636363636,8,574000
2021,county,48085,Collin,41067,Washington,OR,Portland,258,13821000,53569.767441860466,61,3785000,62049.18032786885,197,10036000
2021,county,48085,Collin,05143,Washington,AR,Rural Arkansas,65,2666000,41015.38461538462,78,2568000,32923.07692307692,-13,98000
2021,county,48439,Tarrant,32031,Washoe,NV,Rural Nevada,131,6985000,53320.6106870229,46,2811000,61108.69565217391,85,4174000
2021,county,48113,Dallas,32031,Washoe,NV,Rural Nevada,83,3087000,37192.77108433735,66,3399000,51500.0,17,-312000
2021,county,48439,Tarrant,26161,Washtenaw,MI,Rural Michigan,41,1321000,32219.51219512195,41,1769000,43146.34146341463,0,-448000
2021,county,48439,Tarrant,26163,Wayne,MI,Detroit,232,6266000,27008.620689655174,123,3147000,25585.365853658535,109,3119000
2021,county,48113,Dallas,26163,Wayne,MI,Detroit,175,7467000,42668.57142857143,105,3925000,37380.95238095238,70,3542000
2021,county,48121,Denton,26163,Wayne,MI,Detroit,86,3605000,41918.604651162794,72,2567000,35652.77777777778,14,1038000
2021,county,48085,Collin,26163,Wayne,MI,Detroit,140,5369000,38350.0,67,2646000,39492.53731343283,73,2723000
2021,county,48439,Tarrant,48479,Webb,TX,Rural Texas,118,2263000,19177.966101694914,48,1201000,25020.833333333332,70,1062000
2021,county,48113,Dallas,48479,Webb,TX,Rural Texas,165,3046000,18460.60606060606,135,2076000,15377.777777777777,30,970000
2021,county,48439,Tarrant,08123,Weld,CO,Rural Colorado,88,2657000,30193.18181818182,69,2270000,32898.55072463768,19,387000
2021,county,48113,Dallas,08123,Weld,CO,Rural Colorado,47,1571000,33425.53191489362,51,2473000,48490.19607843137,-4,-902000
2021,county,48121,Denton,08123,Weld,CO,Rural Colorado,45,2212000,49155.555555555555,55,2999000,54527.27272727273,-10,-787000
2021,county,48085,Collin,08123,Weld,CO,Rural Colorado,49,2038000,41591.836734693876,62,2804000,45225.8064516129,-13,-766000
2021,county,48113,Dallas,36119,Westchester,NY,New York,114,18492000,162210.52631578947,48,3807000,79312.5,66,14685000
2021,county,48439,Tarrant,48485,Wichita,TX,Rural Texas,379,9935000,26213.72031662269,373,12100000,32439.678284182304,6,-2165000
2021,county,48113,Dallas,48485,Wichita,TX,Rural Texas,240,5265000,21937.5,252,9500000,37698.4126984127,-12,-4235000
2021,county,48121,Denton,48485,Wichita,TX,Rural Texas,221,7855000,35542.98642533937,127,7420000,58425.1968503937,94,435000
2021,county,48085,Collin,48485,Wichita,TX,Rural Texas,116,2535000,21853.44827586207,101,3130000,30990.09900990099,15,-595000
2021,county,48439,Tarrant,17197,Will,IL,Chicago,147,4790000,32585.034013605444,36,1011000,28083.333333333332,111,3779000
2021,county,48113,Dallas,17197,Will,IL,Chicago,106,5001000,47179.24528301887,56,1945000,34732.142857142855,50,3056000
2021,county,48439,Tarrant,48491,Williamson,TX,Austin,595,23525000,39537.815126050424,634,26742000,42179.81072555205,-39,-3217000
2021,county,48439,Tarrant,47187,Williamson,TN,Nashville,55,2250000,40909.09090909091,67,5173000,77208.95522388059,-12,-2923000
2021,county,48113,Dallas,48491,Williamson,TX,Austin,581,29242000,50330.464716006885,703,37900000,53911.80654338549,-122,-8658000
2021,county,48113,Dallas,47187,Williamson,TN,Nashville,65,3108000,47815.38461538462,93,7223000,77666.66666666667,-28,-4115000
2021,county,48121,Denton,48491,Williamson,TX,Austin,422,20431000,48414.69194312796,412,18417000,44701.45631067961,10,2014000
2021,county,48085,Collin,48491,Williamson,TX,Austin,565,26014000,46042.4778761062,500,31437000,62874.0,65,-5423000
2021,county,48085,Collin,47187,Williamson,TN,Nashville,89,5998000,67393.25842696629,60,4210000,70166.66666666667,29,1788000
2021,county,48439,Tarrant,48497,Wise,TX,Dallas-Fort Worth,902,27726000,30738.359201773837,2509,83152000,33141.49063371861,-1607,-55426000
2021,county,48113,Dallas,48497,Wise,TX,Dallas-Fort Worth,108,3070000,28425.925925925927,257,8509000,33108.94941634241,-149,-5439000
2021,county,48121,Denton,48497,Wise,TX,Dallas-Fort Worth,488,17156000,35155.737704918036,1119,45459000,40624.66487935657,-631,-28303000
2021,county,48085,Collin,48497,Wise,TX,Dallas-Fort Worth,33,925000,28030.303030303032,105,6375000,60714.28571428572,-72,-5450000
2021,county,48439,Tarrant,48499,Wood,TX,Rural Texas,84,3140000,37380.95238095238,214,10189000,47612.14953271028,-130,-7049000
2021,county,48113,Dallas,48499,Wood,TX,Rural Texas,101,2916000,28871.287128712873,344,14918000,43366.27906976744,-243,-12002000
2021,county,48121,Denton,48499,Wood,TX,Rural Texas,49,2387000,48714.28571428572,111,4219000,38009.00900900901,-62,-1832000
2021,county,48085,Collin,48499,Wood,TX,Rural Texas,104,3450000,33173.07692307692,193,13079000,67766.83937823834,-89,-9629000
2021,county,48439,Tarrant,48503,Young,TX,Rural Texas,39,1058000,27128.20512820513,119,5124000,43058.82352941176,-80,-4066000
2021,total,48439,Tarrant,96000,,,,110835,4231714000,38180.30405557811,108107,4112485000,38040.87616898073,2728,119229000
2021,total,48113,Dallas,96000,,,,121147,5807634000,47938.735585693415,152255,6373060000,41857.80434140094,-31108,-565426000
2021,total,48121,Denton,96000,,,,83985,4117749000,49029.57671012681,63438,2778240000,43794.571077272296,20547,1339509000
2021,total,48085,Collin,96000,,,,96779,4706871000,48635.251449178024,68492,3430159000,50081.16276353443,28287,1276712000
2022,county,48439,Tarrant,16001,Ada,ID,Rural Idaho,80,3236000,40450.0,83,3894000,46915.66265060241,-3,-658000
2022,county,48113,Dallas,16001,Ada,ID,Rural Idaho,46,2548000,55391.30434782609,40,3237000,80925.0,6,-689000
2022,county,48121,Denton,16001,Ada,ID,Rural Idaho,52,2948000,56692.307692307695,51,2730000,53529.41176470588,1,218000
2022,county,48085,Collin,16001,Ada,ID,Rural Idaho,66,3370000,51060.606060606064,46,2738000,59521.739130434784,20,632000
2022,county,48439,Tarrant,08001,Adams,CO,Denver,155,6102000,39367.74193548387,107,3780000,35327.102803738315,48,2322000
2022,county,48113,Dallas,08001,Adams,CO,Denver,98,5404000,55142.857142857145,113,4451000,39389.38053097345,-15,953000
2022,county,48121,Denton,08001,Adams,CO,Denver,80,3444000,43050.0,78,3497000,44833.333333333336,2,-53000
2022,county,48085,Collin,08001,Adams,CO,Denver,83,3580000,43132.530120481926,55,4070000,74000.0,28,-490000
2022,county,48113,Dallas,12001,Alachua,FL,Rural Florida,38,1855000,48815.78947368421,40,2153000,53825.0,-2,-298000
2022,county,48439,Tarrant,06001,Alameda,CA,Bay Area,243,18525000,76234.56790123456,109,5001000,45880.733944954125,134,13524000
2022,county,48113,Dallas,06001,Alameda,CA,Bay Area,474,48789000,102930.37974683545,198,13127000,66297.9797979798,276,35662000
2022,county,48121,Denton,06001,Alameda,CA,Bay Area,350,39197000,111991.42857142857,64,4915000,76796.875,286,34282000
2022,county,48085,Collin,06001,Alameda,CA,Bay Area,728,56024000,76956.04395604396,157,11351000,72299.36305732484,571,44673000
2022,county,48439,Tarrant,51510,Alexandria city,VA,D.C.,40,2875000,71875.0,44,1636000,37181.818181818184,-4,1239000
2022,county,48113,Dallas,51510,Alexandria city,VA,D.C.,64,6718000,104968.75,69,3717000,53869.565217391304,-5,3001000
2022,county,48439,Tarrant,42003,Allegheny,PA,Pittsburgh,131,5770000,44045.80152671756,91,3565000,39175.82417582418,40,2205000
2022,county,48113,Dallas,42003,Allegheny,PA,Pittsburgh,247,16903000,68433.1983805668,115,7381000,64182.608695652176,132,9522000
2022,county,48121,Denton,42003,Allegheny,PA,Pittsburgh,101,5107000,50564.35643564357,50,3467000,69340.0,51,1640000
2022,county,48085,Collin,42003,Allegheny,PA,Pittsburgh,276,14268000,51695.65217391304,64,2651000,41421.875,212,11617000
2022,county,48439,Tarrant,18003,Allen,IN,Rural Indiana,77,1955000,25389.61038961039,55,2096000,38109.09090909091,22,-141000
2022,county,48113,Dallas,18003,Allen,IN,Rural Indiana,72,2234000,31027.777777777777,44,2010000,45681.818181818184,28,224000
2022,county,48439,Tarrant,02020,Anchorage Borough,AK,Rural Alaska,82,2597000,31670.731707317074,46,1505000,32717.391304347828,36,1092000
2022,county,48113,Dallas,02020,Anchorage Borough,AK,Rural Alaska,62,2294000,37000.0,38,1153000,30342.105263157893,24,1141000
2022,county,48439,Tarrant,48001,Anderson,TX,Rural Texas,130,3522000,27092.30769230769,100,3721000,37210.0,30,-199000
2022,county,48113,Dallas,48001,Anderson,TX,Rural Texas,98,2153000,21969.38775510204,119,9701000,81521.00840336134,-21,-7548000
2022,county,48439,Tarrant,48005,Angelina,TX,Rural Texas,75,1321000,17613.333333333332,59,1563000,26491.525423728814,16,-242000
2022,county,48113,Dallas,48005,Angelina,TX,Rural Texas,63,2304000,36571.42857142857,62,2120000,34193.54838709677,1,184000
2022,county,48439,Tarrant,24003,Anne Arundel,MD,Baltimore,72,2548000,35388.88888888889,53,2210000,41698.11320754717,19,338000
2022,county,48113,Dallas,24003,Anne Arundel,MD,Baltimore,81,4773000,58925.92592592593,60,3219000,53650.0,21,1554000
2022,county,48439,Tarrant,08005,Arapahoe,CO,Denver,283,16742000,59159.010600706715,220,8829000,40131.818181818184,63,7913000
2022,county,48113,Dallas,08005,Arapahoe,CO,Denver,245,13154000,53689.795918367345,211,17094000,81014.21800947867,34,-3940000
2022,county,48121,Denton,08005,Arapahoe,CO,Denver,201,9816000,48835.82089552239,126,5404000,42888.88888888889,75,4412000
2022,county,48085,Collin,08005,Arapahoe,CO,Denver,203,7323000,36073.89162561576,134,6298000,47000.0,69,1025000
2022,county,48439,Tarrant,51013,Arlington,VA,D.C.,49,4250000,86734.69387755102,33,1748000,52969.69696969697,16,2502000
2022,county,48113,Dallas,51013,Arlington,VA,D.C.,73,7178000,98328.76712328767,96,8898000,92687.5,-23,-1720000
2022,county,48085,Collin,51013,Arlington,VA,D.C.,41,3034000,74000.0,59,3471000,58830.50847457627,-18,-437000
2022,county,48121,Denton,01003,Baldwin,AL,Mobile,30,980000,32666.666666666668,54,3294000,61000.0,-24,-2314000
2022,county,48439,Tarrant,24005,Baltimore,MD,Baltimore,71,2126000,29943.661971830985,47,2157000,45893.617021276594,24,-31000
2022,county,48113,Dallas,24005,Baltimore,MD,Baltimore,99,5431000,54858.58585858586,58,2061000,35534.48275862069,41,3370000
2022,county,48439,Tarrant,24510,Baltimore city,MD,Baltimore,67,2457000,36671.64179104478,36,1218000,33833.333333333336,31,1239000
2022,county,48113,Dallas,24510,Baltimore city,MD,Baltimore,115,6585000,57260.86956521739,71,3657000,51507.042253521126,44,2928000
2022,county,48439,Tarrant,48021,Bastrop,TX,Austin,40,1330000,33250.0,43,1306000,30372.093023255813,-3,24000
2022,county,48113,Dallas,48021,Bastrop,TX,Austin,38,1843000,48500.0,58,3071000,52948.275862068964,-20,-1228000
2022,county,48113,Dallas,45013,Beaufort,SC,Savannah,33,1507000,45666.666666666664,44,5557000,126295.45454545454,-11,-4050000
2022,county,48439,Tarrant,48027,Bell,TX,Rural Texas,540,15267000,28272.222222222223,436,12191000,27961.009174311926,104,3076000
2022,county,48113,Dallas,48027,Bell,TX,Rural Texas,454,13192000,29057.26872246696,438,12610000,28789.954337899544,16,582000
2022,county,48121,Denton,48027,Bell,TX,Rural Texas,176,5536000,31454.545454545456,203,7071000,34832.512315270935,-27,-1535000
2022,county,48085,Collin,48027,Bell,TX,Rural Texas,219,6298000,28757.99086757991,178,7421000,41691.011235955055,41,-1123000
2022,county,48439,Tarrant,05007,Benton,AR,Rural Arkansas,117,5585000,47735.042735042734,136,5478000,40279.41176470588,-19,107000
2022,county,48113,Dallas,05007,Benton,AR,Rural Arkansas,204,15388000,75431.37254901961,188,13337000,70941.48936170213,16,2051000
2022,county,48121,Denton,05007,Benton,AR,Rural Arkansas,145,8226000,56731.03448275862,167,10434000,62479.04191616766,-22,-2208000
2022,county,48085,Collin,05007,Benton,AR,Rural Arkansas,215,13070000,60790.6976744186,189,11081000,58629.62962962963,26,1989000
2022,county,48113,Dallas,34003,Bergen,NJ,New York,132,8904000,67454.54545454546,28,1892000,67571.42857142857,104,7012000
2022,county,48439,Tarrant,35001,Bernalillo,NM,Albuquerque,234,8900000,38034.18803418803,106,4409000,41594.339622641506,128,4491000
2022,county,48113,Dallas,35001,Bernalillo,NM,Albuquerque,185,7632000,41254.05405405405,149,6816000,45744.96644295302,36,816000
2022,county,48121,Denton,35001,Bernalillo,NM,Albuquerque,124,6021000,48556.45161290323,84,3669000,43678.57142857143,40,2352000
2022,county,48085,Collin,35001,Bernalillo,NM,Albuquerque,143,9264000,64783.21678321678,71,3546000,49943.66197183099,72,5718000
2022,county,48439,Tarrant,48029,Bexar,TX,San Antonio,1322,46091000,34864.599092284414,1048,32131000,30659.351145038167,274,13960000
2022,county,48113,Dallas,48029,Bexar,TX,San Antonio,1330,61195000,46011.278195488725,1270,52717000,41509.44881889764,60,8478000
2022,county,48121,Denton,48029,Bexar,TX,San Antonio,648,28088000,43345.67901234568,531,26180000,49303.20150659134,117,1908000
2022,county,48085,Collin,48029,Bexar,TX,San Antonio,755,40148000,53176.15894039735,563,26085000,46332.14920071048,192,14063000
2022,county,48113,Dallas,29019,Boone,MO,Columbia,74,3398000,45918.91891891892,36,1353000,37583.333333333336,38,2045000
2022,county,48439,Tarrant,48035,Bosque,TX,Rural Texas,44,1422000,32318.18181818182,101,3026000,29960.396039603962,-57,-1604000
2022,county,48439,Tarrant,22015,Bossier Parish,LA,Rural Louisiana,176,4088000,23227.272727272728,108,2547000,23583.333333333332,68,1541000
2022,county,48113,Dallas,22015,Bossier Parish,LA,Rural Louisiana,183,4305000,23524.590163934427,109,2621000,24045.871559633026,74,1684000
2022,county,48121,Denton,22015,Bossier Parish,LA,Rural Louisiana,80,1896000,23700.0,52,1787000,34365.38461538462,28,109000
2022,county,48085,Collin,22015,Bossier Parish,LA,Rural Louisiana,72,2167000,30097.222222222223,45,2194000,48755.555555555555,27,-27000
2022,county,48439,Tarrant,08013,Boulder,CO,Denver,66,3511000,53196.969696969696,66,3091000,46833.333333333336,0,420000
2022,county,48113,Dallas,08013,Boulder,CO,Denver,77,4798000,62311.68831168831,91,8461000,92978.02197802198,-14,-3663000
2022,county,48121,Denton,08013,Boulder,CO,Denver,50,3106000,62120.0,53,2925000,55188.67924528302,-3,181000
2022,county,48085,Collin,08013,Boulder,CO,Denver,39,1855000,47564.10256410256,68,5229000,76897.05882352941,-29,-3374000
2022,county,48439,Tarrant,48037,Bowie,TX,Rural Texas,142,3609000,25415.49295774648,134,5172000,38597.014925373136,8,-1563000
2022,county,48113,Dallas,48037,Bowie,TX,Rural Texas,185,4311000,23302.702702702703,159,4812000,30264.150943396227,26,-501000
2022,county,48121,Denton,48037,Bowie,TX,Rural Texas,78,3510000,45000.0,74,3343000,45175.67567567567,4,167000
2022,county,48085,Collin,48037,Bowie,TX,Rural Texas,76,2472000,32526.315789473683,85,3197000,37611.76470588235,-9,-725000
2022,county,48439,Tarrant,48039,Brazoria,TX,Houston,146,4479000,30678.08219178082,180,6469000,35938.88888888889,-34,-1990000
2022,county,48113,Dallas,48039,Brazoria,TX,Houston,149,5767000,38704.69798657718,211,7301000,34601.89573459716,-62,-1534000
2022,county,48121,Denton,48039,Brazoria,TX,Houston,108,4231000,39175.92592592593,70,2605000,37214.28571428572,38,1626000
2022,county,48085,Collin,48039,Brazoria,TX,Houston,78,4957000,63551.282051282054,88,2655000,30170.454545454544,-10,2302000
2022,county,48439,Tarrant,48041,Brazos,TX,Rural Texas,330,17766000,53836.36363636364,262,13965000,53301.52671755725,68,3801000
2022,county,48113,Dallas,48041,Brazos,TX,Rural Texas,331,11655000,35211.48036253776,242,8246000,34074.38016528926,89,3409000
2022,county,48121,Denton,48041,Brazos,TX,Rural Texas,147,5702000,38789.115646258506,119,4904000,41210.08403361344,28,798000
2022,county,48085,Collin,48041,Brazos,TX,Rural Texas,211,8211000,38914.69194312796,194,7315000,37706.18556701031,17,896000
2022,county,48439,Tarrant,12009,Brevard,FL,Atlantic Coast,61,2544000,41704.91803278688,115,5699000,49556.52173913043,-54,-3155000
2022,county,48113,Dallas,12009,Brevard,FL,Atlantic Coast,60,2669000,44483.333333333336,75,5930000,79066.66666666667,-15,-3261000
2022,county,48085,Collin,12009,Brevard,FL,Atlantic Coast,61,4301000,70508.19672131147,67,8963000,133776.1194029851,-6,-4662000
2022,county,48085,Collin,08014,Broomfield,CO,Denver,37,2110000,57027.02702702703,46,1823000,39630.434782608696,-9,287000
2022,county,48439,Tarrant,12011,Broward,FL,Miami,279,9435000,33817.20430107527,198,10376000,52404.0404040404,81,-941000
2022,county,48113,Dallas,12011,Broward,FL,Miami,421,37493000,89057.00712589074,258,15893000,61600.77519379845,163,21600000
2022,county,48121,Denton,12011,Broward,FL,Miami,193,8973000,46492.22797927461,127,8753000,68921.25984251969,66,220000
2022,county,48085,Collin,12011,Broward,FL,Miami,221,8498000,38452.4886877828,154,12030000,78116.88311688312,67,-3532000
2022,county,48439,Tarrant,48049,Brown,TX,Rural Texas,82,2347000,28621.951219512193,100,3420000,34200.0,-18,-1073000
2022,county,48113,Dallas,40013,Bryan,OK,Rural Oklahoma,31,689000,22225.8064516129,77,2561000,33259.74025974026,-46,-1872000
2022,county,48085,Collin,40013,Bryan,OK,Rural Oklahoma,44,1240000,28181.81818181818,93,4857000,52225.8064516129,-49,-3617000
2022,county,48439,Tarrant,34005,Burlington,NJ,Philadelphia,54,2564000,47481.48148148148,69,1761000,25521.739130434784,-15,803000
2022,county,48439,Tarrant,48053,Burnet,TX,Rural Texas,65,1915000,29461.53846153846,68,8203000,120632.35294117648,-3,-6288000
2022,county,48113,Dallas,48053,Burnet,TX,Rural Texas,30,1644000,54800.0,57,4454000,78140.35087719298,-27,-2810000
2022,county,48439,Tarrant,39017,Butler,OH,Cincinnati,45,1398000,31066.666666666668,57,849000,14894.736842105263,-12,549000
2022,county,48113,Dallas,39017,Butler,OH,Cincinnati,32,1354000,42312.5,51,1238000,24274.50980392157,-19,116000
2022,county,48439,Tarrant,22017,Caddo Parish,LA,Rural Louisiana,494,8709000,17629.554655870445,222,4551000,20500.0,272,4158000
2022,county,48113,Dallas,22017,Caddo Parish,LA,Rural Louisiana,589,13300000,22580.645161290322,326,8981000,27549.079754601225,263,4319000
2022,county,48121,Denton,22017,Caddo Parish,LA,Rural Louisiana,209,4722000,22593.301435406698,60,1379000,22983.333333333332,149,3343000
2022,county,48085,Collin,22017,Caddo Parish,LA,Rural Louisiana,215,5719000,26600.0,91,1670000,18351.648351648353,124,4049000
2022,county,48113,Dallas,22019,Calcasieu Parish,LA,Rural Louisiana,94,1629000,17329.787234042553,62,1021000,16467.74193548387,32,608000
2022,county,48439,Tarrant,48061,Cameron,TX,Rural Texas,144,4171000,28965.277777777777,187,6097000,32604.27807486631,-43,-1926000
2022,county,48113,Dallas,48061,Cameron,TX,Rural Texas,163,4913000,30141.104294478526,179,4560000,25474.86033519553,-16,353000
2022,county,48121,Denton,48061,Cameron,TX,Rural Texas,68,2493000,36661.76470588235,53,1575000,29716.98113207547,15,918000
2022,county,48085,Collin,48061,Cameron,TX,Rural Texas,60,1909000,31816.666666666668,51,2378000,46627.450980392154,9,-469000
2022,county,48439,Tarrant,40017,Canadian,OK,Oklahoma City,80,2269000,28362.5,124,3917000,31588.709677419356,-44,-1648000
2022,county,48113,Dallas,40017,Canadian,OK,Oklahoma City,47,1510000,32127.659574468085,59,1759000,29813.5593220339,-12,-249000
2022,county,48121,Denton,40017,Canadian,OK,Oklahoma City,35,1256000,35885.71428571428,48,1473000,30687.5,-13,-217000
2022,county,48085,Collin,40017,Canadian,OK,Oklahoma City,69,1985000,28768.115942028984,68,2162000,31794.117647058825,1,-177000
2022,county,48439,Tarrant,09110,Capitol,CT,Hartford,101,3740000,37029.70297029703,47,2465000,52446.8085106383,54,1275000
2022,county,48113,Dallas,09110,Capitol,CT,Hartford,492,-33395000,-67876.0162601626,90,6411000,71233.33333333333,402,-39806000
2022,county,48085,Collin,09110,Capitol,CT,Hartford,220,12422000,56463.63636363636,39,1768000,45333.333333333336,181,10654000
2022,county,48439,Tarrant,40019,Carter,OK,Rural Oklahoma,38,1747000,45973.68421052631,62,1994000,32161.290322580644,-24,-247000
2022,county,48113,Dallas,40019,Carter,OK,Rural Oklahoma,38,1532000,40315.78947368421,38,1714000,45105.26315789474,0,-182000
2022,county,48121,Denton,40019,Carter,OK,Rural Oklahoma,60,2423000,40383.333333333336,72,2264000,31444.444444444445,-12,159000
2022,county,48113,Dallas,48067,Cass,TX,Rural Texas,39,793000,20333.333333333332,55,1935000,35181.818181818184,-16,-1142000
2022,county,48113,Dallas,17019,Champaign,IL,Rural Illinois,53,2154000,40641.50943396227,32,953000,29781.25,21,1201000
2022,county,48439,Tarrant,45019,Charleston,SC,Charleston,52,2004000,38538.46153846154,47,3512000,74723.40425531915,5,-1508000
2022,county,48113,Dallas,45019,Charleston,SC,Charleston,58,5208000,89793.10344827586,59,5905000,100084.74576271187,-1,-697000
2022,county,48439,Tarrant,13051,Chatham,GA,Savannah,56,2157000,38517.857142857145,44,1994000,45318.181818181816,12,163000
2022,county,48113,Dallas,13051,Chatham,GA,Savannah,55,1713000,31145.454545454544,35,1848000,52800.0,20,-135000
2022,county,48439,Tarrant,48073,Cherokee,TX,Rural Texas,68,1096000,16117.64705882353,79,2194000,27772.151898734177,-11,-1098000
2022,county,48439,Tarrant,13057,Cherokee,GA,Atlanta,42,1198000,28523.809523809523,54,2854000,52851.851851851854,-12,-1656000
2022,county,48113,Dallas,48073,Cherokee,TX,Rural Texas,47,1101000,23425.531914893618,105,2317000,22066.666666666668,-58,-1216000
2022,county,48113,Dallas,42029,Chester,PA,Philadelphia,58,3046000,52517.24137931035,42,2292000,54571.42857142857,16,754000
2022,county,48085,Collin,42029,Chester,PA,Philadelphia,107,8591000,80289.71962616823,47,2568000,54638.29787234042,60,6023000
2022,county,48439,Tarrant,41005,Clackamas,OR,Portland,62,3649000,58854.83870967742,36,2454000,68166.66666666667,26,1195000
2022,county,48439,Tarrant,32003,Clark,NV,Las Vegas,698,26979000,38651.86246418338,383,16863000,44028.72062663185,315,10116000
2022,county,48439,Tarrant,53011,Clark,WA,Portland,106,4637000,43745.28301886792,61,1872000,30688.524590163935,45,2765000
2022,county,48113,Dallas,32003,Clark,NV,Las Vegas,595,26765000,44983.19327731092,457,17154000,37536.10503282276,138,9611000
2022,county,48113,Dallas,53011,Clark,WA,Portland,76,5717000,75223.68421052632,65,3181000,48938.46153846154,11,2536000
2022,county,48121,Denton,32003,Clark,NV,Las Vegas,376,22080000,58723.40425531915,202,9442000,46742.574257425746,174,12638000
2022,county,48121,Denton,53011,Clark,WA,Portland,111,6014000,54180.18018018018,63,3382000,53682.53968253968,48,2632000
2022,county,48085,Collin,32003,Clark,NV,Las Vegas,563,27544000,48923.623445825935,240,14006000,58358.333333333336,323,13538000
2022,county,48439,Tarrant,29047,Clay,MO,Kansas City,42,1971000,46928.57142857143,46,1569000,34108.69565217391,-4,402000
2022,county,48439,Tarrant,12019,Clay,FL,Jacksonville,48,1317000,27437.5,47,1798000,38255.31914893617,1,-481000
2022,county,48439,Tarrant,13063,Clayton,GA,Atlanta,53,1159000,21867.924528301886,39,1008000,25846.153846153848,14,151000
2022,county,48113,Dallas,13063,Clayton,GA,Atlanta,43,849000,19744.18604651163,37,534000,14432.432432432432,6,315000
2022,county,48439,Tarrant,40027,Cleveland,OK,Oklahoma City,161,6299000,39124.223602484475,182,7255000,39862.63736263736,-21,-956000
2022,county,48113,Dallas,40027,Cleveland,OK,Oklahoma City,172,6257000,36377.90697674418,157,5544000,35312.10191082802,15,713000
2022,county,48121,Denton,40027,Cleveland,OK,Oklahoma City,109,4353000,39935.779816513765,143,7129000,49853.146853146856,-34,-2776000
2022,county,48085,Collin,40027,Cleveland,OK,Oklahoma City,84,4630000,55119.04761904762,97,4401000,45371.134020618556,-13,229000
2022,county,48439,Tarrant,13067,Cobb,GA,Atlanta,108,4439000,41101.851851851854,160,7381000,46131.25,-52,-2942000
2022,county,48113,Dallas,13067,Cobb,GA,Atlanta,197,12282000,62345.17766497462,147,6756000,45959.183673469386,50,5526000
2022,county,48121,Denton,13067,Cobb,GA,Atlanta,77,4902000,63662.33766233766,90,4343000,48255.555555555555,-13,559000
2022,county,48085,Collin,13067,Cobb,GA,Atlanta,100,5368000,53680.0,97,4105000,42319.58762886598,3,1263000
2022,county,48439,Tarrant,12021,Collier,FL,S.W. Florida,49,2871000,58591.836734693876,39,2250000,57692.307692307695,10,621000
2022,county,48113,Dallas,12021,Collier,FL,S.W. Florida,56,17000000,303571.4285714286,68,18816000,276705.8823529412,-12,-1816000
2022,county,48085,Collin,12021,Collier,FL,S.W. Florida,45,1869000,41533.333333333336,46,6143000,133543.47826086957,-1,-4274000
2022,county,48439,Tarrant,48085,Collin,TX,Dallas-Fort Worth,3266,157162000,48120.63686466626,3262,150464000,46126.30288166769,4,6698000
2022,county,48113,Dallas,48085,Collin,TX,Dallas-Fort Worth,15351,830334000,54089.89642368575,22466,1102503000,49074.290038280065,-7115,-272169000
2022,county,48121,Denton,48085,Collin,TX,Dallas-Fort Worth,13998,774997000,55364.837833976286,12866,681156000,52942.32861806311,1132,93841000
2022,county,48439,Tarrant,48091,Comal,TX,San Antonio,127,5832000,45921.259842519685,150,9264000,61760.0,-23,-3432000
2022,county,48113,Dallas,48091,Comal,TX,San Antonio,78,4375000,56089.743589743586,138,12241000,88702.89855072464,-60,-7866000
2022,county,48121,Denton,48091,Comal,TX,San Antonio,86,4435000,51569.767441860466,93,6774000,72838.70967741935,-7,-2339000
2022,county,48085,Collin,48091,Comal,TX,San Antonio,41,2911000,71000.0,141,8818000,62539.00709219858,-100,-5907000
2022,county,48439,Tarrant,40031,Comanche,OK,Rural Oklahoma,152,5010000,32960.52631578947,131,2267000,17305.34351145038,21,2743000
2022,county,48113,Dallas,40031,Comanche,OK,Rural Oklahoma,116,3059000,26370.689655172413,70,1412000,20171.428571428572,46,1647000
2022,county,48121,Denton,40031,Comanche,OK,Rural Oklahoma,49,1379000,28142.85714285714,52,1581000,30403.846153846152,-3,-202000
2022,county,48439,Tarrant,06013,Contra Costa,CA,Bay Area,243,19791000,81444.44444444444,70,2993000,42757.142857142855,173,16798000
2022,county,48113,Dallas,06013,Contra Costa,CA,Bay Area,216,13108000,60685.18518518518,80,14045000,175562.5,136,-937000
2022,county,48085,Collin,06013,Contra Costa,CA,Bay Area,293,24578000,83883.9590443686,71,8143000,114690.14084507042,222,16435000
2022,county,48439,Tarrant,17031,Cook,IL,Chicago,777,56722000,73001.287001287,419,17481000,41720.76372315036,358,39241000
2022,county,48113,Dallas,17031,Cook,IL,Chicago,1506,145356000,96517.92828685259,893,56972000,63798.43225083987,613,88384000
2022,county,48121,Denton,17031,Cook,IL,Chicago,675,55127000,81669.62962962964,213,11154000,52366.19718309859,462,43973000
2022,county,48085,Collin,17031,Cook,IL,Chicago,1260,71927000,57084.920634920636,291,15321000,52649.48453608248,969,56606000
2022,county,48439,Tarrant,48097,Cooke,TX,Rural Texas,87,2558000,29402.298850574713,182,6011000,33027.47252747253,-95,-3453000
2022,county,48113,Dallas,48097,Cooke,TX,Rural Texas,81,2415000,29814.814814814814,127,8367000,65881.88976377953,-46,-5952000
2022,county,48121,Denton,48097,Cooke,TX,Rural Texas,444,13459000,30313.063063063062,1072,69556000,64884.32835820896,-628,-56097000
2022,county,48085,Collin,48097,Cooke,TX,Rural Texas,51,1947000,38176.470588235294,144,7291000,50631.944444444445,-93,-5344000
2022,county,48439,Tarrant,48099,Coryell,TX,Rural Texas,123,2573000,20918.69918699187,97,1870000,19278.350515463917,26,703000
2022,county,48113,Dallas,48099,Coryell,TX,Rural Texas,74,1265000,17094.594594594593,72,2033000,28236.11111111111,2,-768000
2022,county,48439,Tarrant,37051,Cumberland,NC,Rural North Carolina,86,2117000,24616.279069767443,55,1270000,23090.909090909092,31,847000
2022,county,48113,Dallas,37051,Cumberland,NC,Rural North Carolina,88,2323000,26397.727272727272,81,1956000,24148.14814814815,7,367000
2022,county,48439,Tarrant,39035,Cuyahoga,OH,Cleveland,60,2010000,33500.0,58,1777000,30637.931034482757,2,233000
2022,county,48113,Dallas,39035,Cuyahoga,OH,Cleveland,158,9804000,62050.63291139241,99,22389000,226151.51515151514,59,-12585000
2022,county,48121,Denton,39035,Cuyahoga,OH,Cleveland,66,5154000,78090.90909090909,44,2476000,56272.72727272727,22,2678000
2022,county,48085,Collin,39035,Cuyahoga,OH,Cleveland,137,6538000,47722.62773722628,45,1817000,40377.77777777778,92,4721000
2022,county,48439,Tarrant,27037,Dakota,MN,Minneapolis,62,2793000,45048.3870967742,41,1011000,24658.536585365855,21,1782000
2022,county,48113,Dallas,27037,Dakota,MN,Minneapolis,62,2849000,45951.6129032258,40,1104000,27600.0,22,1745000
2022,county,48439,Tarrant,48113,Dallas,TX,Dallas-Fort Worth,23958,1180219000,49262.000166958846,18231,642173000,35224.23344852175,5727,538046000
2022,county,48121,Denton,48113,Dallas,TX,Dallas-Fort Worth,16867,1089116000,64570.81875852256,10377,441000000,42497.8317432784,6490,648116000
2022,county,48085,Collin,48113,Dallas,TX,Dallas-Fort Worth,22466,1102503000,49074.290038280065,15351,830334000,54089.89642368575,7115,272169000
2022,county,48439,Tarrant,55025,Dane,WI,Madison,60,1964000,32733.333333333332,61,2342000,38393.44262295082,-1,-378000
2022,county,48113,Dallas,55025,Dane,WI,Madison,109,6373000,58467.88990825688,60,3500000,58333.333333333336,49,2873000
2022,county,48085,Collin,55025,Dane,WI,Madison,132,6964000,52757.57575757576,46,3202000,69608.69565217392,86,3762000
2022,county,48439,Tarrant,47037,Davidson,TN,Nashville,176,8694000,49397.72727272727,117,5103000,43615.38461538462,59,3591000
2022,county,48113,Dallas,47037,Davidson,TN,Nashville,277,18450000,66606.49819494585,239,14480000,60585.77405857741,38,3970000
2022,county,48121,Denton,47037,Davidson,TN,Nashville,83,14365000,173072.2891566265,61,3125000,51229.50819672131,22,11240000
2022,county,48085,Collin,47037,Davidson,TN,Nashville,86,5349000,62197.67441860465,80,4999000,62487.5,6,350000
2022,county,48439,Tarrant,49011,Davis,UT,Rural Utah,59,2046000,34677.96610169492,43,2091000,48627.90697674418,16,-45000
2022,county,48439,Tarrant,13089,DeKalb,GA,Atlanta,132,4069000,30825.757575757576,98,2820000,28775.51020408163,34,1249000
2022,county,48113,Dallas,13089,DeKalb,GA,Atlanta,248,12452000,50209.67741935484,177,9688000,54734.463276836155,71,2764000
2022,county,48121,Denton,13089,DeKalb,GA,Atlanta,50,2805000,56100.0,47,1738000,36978.72340425532,3,1067000
2022,county,48085,Collin,13089,DeKalb,GA,Atlanta,105,5678000,54076.19047619047,66,3936000,59636.36363636364,39,1742000
2022,county,48439,Tarrant,28033,DeSoto,MS,Memphis,61,1334000,21868.852459016394,45,1213000,26955.555555555555,16,121000
2022,county,48113,Dallas,42045,Delaware,PA,Philadelphia,56,2616000,46714.28571428572,39,2233000,57256.41025641026,17,383000
2022,county,48439,Tarrant,48121,Denton,TX,Dallas-Fort Worth,8006,340745000,42561.20409692731,10098,520440000,51538.91859774213,-2092,-179695000
2022,county,48113,Dallas,48121,Denton,TX,Dallas-Fort Worth,10377,441000000,42497.8317432784,16867,1089116000,64570.81875852256,-6490,-648116000
2022,county,48085,Collin,48121,Denton,TX,Dallas-Fort Worth,12866,681156000,52942.32861806311,13998,774997000,55364.837833976286,-1132,-93841000
2022,county,48439,Tarrant,08031,Denver,CO,Denver,220,9832000,44690.90909090909,253,12346000,48798.418972332016,-33,-2514000
2022,county,48113,Dallas,08031,Denver,CO,Denver,348,22771000,65433.90804597701,527,48383000,91808.34914611006,-179,-25612000
2022,county,48121,Denton,08031,Denver,CO,Denver,108,5246000,48574.07407407407,108,5833000,54009.25925925926,0,-587000
2022,county,48085,Collin,08031,Denver,CO,Denver,119,8275000,69537.81512605042,139,11775000,84712.23021582734,-20,-3500000
2022,county,48439,Tarrant,11001,District of Columbia,DC,D.C.,70,4385000,62642.857142857145,52,4901000,94250.0,18,-516000
2022,county,48113,Dallas,11001,District of Columbia,DC,D.C.,140,22547000,161050.0,174,13339000,76660.91954022988,-34,9208000
2022,county,48085,Collin,11001,District of Columbia,DC,D.C.,29,2213000,76310.3448275862,52,3041000,58480.769230769234,-23,-828000
2022,county,48439,Tarrant,35013,Dona Ana,NM,Rural New Mexico,70,2211000,31585.714285714286,59,1844000,31254.237288135595,11,367000
2022,county,48113,Dallas,35013,Dona Ana,NM,Rural New Mexico,43,1065000,24767.441860465115,37,1735000,46891.89189189189,6,-670000
2022,county,48439,Tarrant,31055,Douglas,NE,Omaha,192,8326000,43364.583333333336,107,3167000,29598.130841121496,85,5159000
2022,county,48439,Tarrant,08035,Douglas,CO,Denver,158,12178000,77075.9493670886,195,11228000,57579.48717948718,-37,950000
2022,county,48113,Dallas,31055,Douglas,NE,Omaha,157,8816000,56152.86624203822,84,4603000,54797.619047619046,73,4213000
2022,county,48113,Dallas,08035,Douglas,CO,Denver,106,6200000,58490.56603773585,131,7698000,58763.35877862595,-25,-1498000
2022,county,48121,Denton,08035,Douglas,CO,Denver,153,7838000,51228.75816993464,140,11391000,81364.28571428571,13,-3553000
2022,county,48121,Denton,31055,Douglas,NE,Omaha,138,5284000,38289.85507246377,62,5271000,85016.12903225806,76,13000
2022,county,48085,Collin,08035,Douglas,CO,Denver,189,9858000,52158.730158730155,183,11180000,61092.89617486339,6,-1322000
2022,county,48085,Collin,31055,Douglas,NE,Omaha,140,6709000,47921.42857142857,51,2561000,50215.686274509804,89,4148000
2022,county,48439,Tarrant,17043,DuPage,IL,Chicago,192,14930000,77760.41666666667,61,2131000,34934.42622950819,131,12799000
2022,county,48113,Dallas,17043,DuPage,IL,Chicago,238,13279000,55794.117647058825,128,6823000,53304.6875,110,6456000
2022,county,48121,Denton,17043,DuPage,IL,Chicago,240,15853000,66054.16666666667,58,3724000,64206.89655172414,182,12129000
2022,county,48085,Collin,17043,DuPage,IL,Chicago,447,23023000,51505.592841163314,118,4965000,42076.27118644068,329,18058000
2022,county,48439,Tarrant,37063,Durham,NC,Raleigh,51,3411000,66882.35294117648,40,1008000,25200.0,11,2403000
2022,county,48113,Dallas,37063,Durham,NC,Raleigh,117,6986000,59709.40170940171,79,3579000,45303.79746835443,38,3407000
2022,county,48439,Tarrant,12031,Duval,FL,Jacksonville,212,6919000,32636.79245283019,145,5415000,37344.8275862069,67,1504000
2022,county,48113,Dallas,12031,Duval,FL,Jacksonville,186,7952000,42752.68817204301,167,9462000,56658.68263473054,19,-1510000
2022,county,48121,Denton,12031,Duval,FL,Jacksonville,110,5298000,48163.63636363636,74,3815000,51554.05405405405,36,1483000
2022,county,48085,Collin,12031,Duval,FL,Jacksonville,117,6060000,51794.8717948718,117,8333000,71222.22222222222,0,-2273000
2022,county,48439,Tarrant,22033,East Baton Rouge Parish,LA,Rural Louisiana,204,5111000,25053.92156862745,55,1462000,26581.81818181818,149,3649000
2022,county,48113,Dallas,22033,East Baton Rouge Parish,LA,Rural Louisiana,237,6748000,28472.573839662447,94,3678000,39127.65957446808,143,3070000
2022,county,48121,Denton,22033,East Baton Rouge Parish,LA,Rural Louisiana,94,2695000,28670.212765957447,47,1101000,23425.531914893618,47,1594000
2022,county,48085,Collin,22033,East Baton Rouge Parish,LA,Rural Louisiana,155,6184000,39896.77419354839,50,1268000,25360.0,105,4916000
2022,county,48439,Tarrant,48135,Ector,TX,Rural Texas,229,6397000,27934.49781659389,156,3885000,24903.846153846152,73,2512000
2022,county,48113,Dallas,48135,Ector,TX,Rural Texas,167,4446000,26622.754491017964,120,4125000,34375.0,47,321000
2022,county,48121,Denton,48135,Ector,TX,Rural Texas,86,5636000,65534.88372093023,53,902000,17018.867924528302,33,4734000
2022,county,48085,Collin,48135,Ector,TX,Rural Texas,87,5587000,64218.3908045977,50,1699000,33980.0,37,3888000
2022,county,48439,Tarrant,48141,El Paso,TX,El Paso,545,15694000,28796.330275229357,395,11681000,29572.151898734177,150,4013000
2022,county,48439,Tarrant,08041,El Paso,CO,Colorado Springs,269,8200000,30483.271375464683,358,13149000,36729.05027932961,-89,-4949000
2022,county,48113,Dallas,48141,El Paso,TX,El Paso,546,17934000,32846.153846153844,404,14634000,36222.77227722772,142,3300000
2022,county,48113,Dallas,08041,El Paso,CO,Colorado Springs,184,7686000,41771.739130434784,280,13503000,48225.0,-96,-5817000
2022,county,48121,Denton,48141,El Paso,TX,El Paso,259,8543000,32984.555984555984,156,4989000,31980.76923076923,103,3554000
2022,county,48121,Denton,08041,El Paso,CO,Colorado Springs,182,7867000,43225.27472527473,198,9223000,46580.80808080808,-16,-1356000
2022,county,48085,Collin,48141,El Paso,TX,El Paso,247,10298000,41692.307692307695,158,5245000,33196.20253164557,89,5053000
2022,county,48085,Collin,08041,El Paso,CO,Colorado Springs,180,6158000,34211.11111111111,236,11975000,50741.52542372881,-56,-5817000
2022,county,48439,Tarrant,48139,Ellis,TX,Dallas-Fort Worth,1446,49464000,34207.46887966805,3335,121619000,36467.46626686657,-1889,-72155000
2022,county,48113,Dallas,48139,Ellis,TX,Dallas-Fort Worth,2590,91724000,35414.67181467181,6593,213117000,32324.738358865463,-4003,-121393000
2022,county,48121,Denton,48139,Ellis,TX,Dallas-Fort Worth,279,9440000,33835.12544802867,515,20674000,40143.68932038835,-236,-11234000
2022,county,48085,Collin,48139,Ellis,TX,Dallas-Fort Worth,213,12644000,59361.50234741784,438,18914000,43182.64840182648,-225,-6270000
2022,county,48439,Tarrant,48143,Erath,TX,Rural Texas,236,6826000,28923.728813559323,239,8536000,35715.48117154812,-3,-1710000
2022,county,48113,Dallas,48143,Erath,TX,Rural Texas,58,1217000,20982.758620689656,70,8382000,119742.85714285714,-12,-7165000
2022,county,48121,Denton,48143,Erath,TX,Rural Texas,47,1951000,41510.63829787234,48,2016000,42000.0,-1,-65000
2022,county,48439,Tarrant,36029,Erie,NY,Buffalo,94,2192000,23319.14893617021,60,2297000,38283.333333333336,34,-105000
2022,county,48113,Dallas,36029,Erie,NY,Buffalo,137,6311000,46065.69343065693,57,1997000,35035.087719298244,80,4314000
2022,county,48439,Tarrant,12033,Escambia,FL,FL Panhandle,71,1559000,21957.74647887324,74,2784000,37621.62162162162,-3,-1225000
2022,county,48113,Dallas,12033,Escambia,FL,FL Panhandle,79,2359000,29860.759493670885,56,2650000,47321.42857142857,23,-291000
2022,county,48439,Tarrant,25009,Essex,MA,Boston,65,2685000,41307.692307692305,26,1856000,71384.61538461539,39,829000
2022,county,48113,Dallas,34013,Essex,NJ,New York,105,5415000,51571.42857142857,46,1903000,41369.565217391304,59,3512000
2022,county,48439,Tarrant,51059,Fairfax,VA,D.C.,206,20153000,97830.09708737864,111,5254000,47333.333333333336,95,14899000
2022,county,48113,Dallas,51059,Fairfax,VA,D.C.,334,20063000,60068.8622754491,154,13546000,87961.03896103895,180,6517000
2022,county,48121,Denton,51059,Fairfax,VA,D.C.,174,12805000,73591.9540229885,61,4271000,70016.39344262295,113,8534000
2022,county,48085,Collin,51059,Fairfax,VA,D.C.,458,25977000,56718.34061135371,128,9800000,76562.5,330,16177000
2022,county,48439,Tarrant,48147,Fannin,TX,Rural Texas,48,1278000,26625.0,97,2645000,27268.0412371134,-49,-1367000
2022,county,48113,Dallas,48147,Fannin,TX,Rural Texas,107,2678000,25028.03738317757,231,6567000,28428.571428571428,-124,-3889000
2022,county,48121,Denton,48147,Fannin,TX,Rural Texas,44,1377000,31295.454545454544,169,4963000,29366.863905325445,-125,-3586000
2022,county,48085,Collin,48147,Fannin,TX,Rural Texas,265,10222000,38573.58490566038,619,25458000,41127.62520193861,-354,-15236000
2022,county,48113,Dallas,05045,Faulkner,AR,Little Rock,41,1574000,38390.243902439026,34,1276000,37529.41176470588,7,298000
2022,county,48439,Tarrant,21067,Fayette,KY,Lexington,43,1993000,46348.83720930233,42,1196000,28476.190476190477,1,797000
2022,county,48113,Dallas,21067,Fayette,KY,Lexington,51,1879000,36843.13725490196,38,4577000,120447.36842105263,13,-2698000
2022,county,48439,Tarrant,37067,Forsyth,NC,Greensboro,33,2833000,85848.48484848485,44,1274000,28954.545454545456,-11,1559000
2022,county,48113,Dallas,37067,Forsyth,NC,Greensboro,46,2264000,49217.391304347824,45,1507000,33488.88888888889,1,757000
2022,county,48113,Dallas,13117,Forsyth,GA,Atlanta,36,2633000,73138.88888888889,49,4164000,84979.59183673469,-13,-1531000
2022,county,48121,Denton,13117,Forsyth,GA,Atlanta,76,6632000,87263.15789473684,66,4116000,62363.63636363636,10,2516000
2022,county,48085,Collin,13117,Forsyth,GA,Atlanta,88,4428000,50318.181818181816,69,5488000,79536.23188405797,19,-1060000
2022,county,48439,Tarrant,48157,Fort Bend,TX,Houston,373,16405000,43981.23324396783,351,13286000,37851.851851851854,22,3119000
2022,county,48113,Dallas,48157,Fort Bend,TX,Houston,457,22146000,48459.51859956236,511,24258000,47471.62426614481,-54,-2112000
2022,county,48121,Denton,48157,Fort Bend,TX,Houston,325,18443000,56747.692307692305,220,10112000,45963.63636363636,105,8331000
2022,county,48085,Collin,48157,Fort Bend,TX,Houston,485,24564000,50647.42268041237,427,43616000,102145.19906323185,58,-19052000
2022,county,48439,Tarrant,39049,Franklin,OH,Columbus,162,7437000,45907.40740740741,178,7381000,41466.29213483146,-16,56000
2022,county,48113,Dallas,39049,Franklin,OH,Columbus,283,17110000,60459.363957597176,135,10681000,79118.51851851853,148,6429000
2022,county,48121,Denton,39049,Franklin,OH,Columbus,151,7291000,48284.76821192053,38,1296000,34105.26315789474,113,5995000
2022,county,48085,Collin,39049,Franklin,OH,Columbus,249,11554000,46401.60642570281,89,3009000,33808.988764044945,160,8545000
2022,county,48439,Tarrant,48161,Freestone,TX,Rural Texas,34,1023000,30088.235294117647,69,2438000,35333.333333333336,-35,-1415000
2022,county,48113,Dallas,48161,Freestone,TX,Rural Texas,48,784000,16333.333333333334,110,2955000,26863.636363636364,-62,-2171000
2022,county,48439,Tarrant,06019,Fresno,CA,Fresno,123,4048000,32910.56910569106,42,981000,23357.14285714286,81,3067000
2022,county,48113,Dallas,06019,Fresno,CA,Fresno,104,3411000,32798.07692307692,59,1463000,24796.610169491527,45,1948000
2022,county,48439,Tarrant,13121,Fulton,GA,Atlanta,195,12563000,64425.64102564102,180,10851000,60283.333333333336,15,1712000
2022,county,48113,Dallas,13121,Fulton,GA,Atlanta,440,30799000,69997.72727272728,456,57135000,125296.05263157895,-16,-26336000
2022,county,48121,Denton,13121,Fulton,GA,Atlanta,140,13877000,99121.42857142857,114,6226000,54614.0350877193,26,7651000
2022,county,48085,Collin,13121,Fulton,GA,Atlanta,261,25690000,98429.11877394636,173,9795000,56618.49710982659,88,15895000
2022,county,48439,Tarrant,48167,Galveston,TX,Houston,148,6298000,42554.05405405405,280,13193000,47117.857142857145,-132,-6895000
2022,county,48113,Dallas,48167,Galveston,TX,Houston,183,6297000,34409.83606557377,208,9667000,46475.96153846154,-25,-3370000
2022,county,48121,Denton,48167,Galveston,TX,Houston,81,3738000,46148.148148148146,122,5536000,45377.04918032787,-41,-1798000
2022,county,48085,Collin,48167,Galveston,TX,Houston,69,2406000,34869.565217391304,112,5570000,49732.142857142855,-43,-3164000
2022,county,48439,Tarrant,26049,Genesee,MI,Rural Michigan,120,1401000,11675.0,71,1921000,27056.338028169015,49,-520000
2022,county,48113,Dallas,26049,Genesee,MI,Rural Michigan,57,1611000,28263.157894736843,49,1157000,23612.244897959183,8,454000
2022,county,48439,Tarrant,48181,Grayson,TX,Rural Texas,237,6882000,29037.974683544304,382,15093000,39510.471204188485,-145,-8211000
2022,county,48113,Dallas,48181,Grayson,TX,Rural Texas,398,15125000,38002.51256281407,651,21120000,32442.396313364054,-253,-5995000
2022,county,48121,Denton,48181,Grayson,TX,Rural Texas,461,21010000,45574.83731019523,1178,45684000,38780.98471986418,-717,-24674000
2022,county,48085,Collin,48181,Grayson,TX,Rural Texas,1245,57167000,45917.26907630522,2855,139524000,48870.052539404554,-1610,-82357000
2022,county,48439,Tarrant,29077,Greene,MO,Rural Missouri,41,1396000,34048.78048780488,50,2021000,40420.0,-9,-625000
2022,county,48113,Dallas,29077,Greene,MO,Rural Missouri,62,2518000,40612.903225806454,29,1011000,34862.06896551724,33,1507000
2022,county,48439,Tarrant,45045,Greenville,SC,Greenville,48,3629000,75604.16666666667,105,4630000,44095.23809523809,-57,-1001000
2022,county,48113,Dallas,45045,Greenville,SC,Greenville,43,1615000,37558.13953488372,52,3233000,62173.07692307692,-9,-1618000
2022,county,48439,Tarrant,48183,Gregg,TX,Rural Texas,170,5278000,31047.058823529413,150,5676000,37840.0,20,-398000
2022,county,48113,Dallas,48183,Gregg,TX,Rural Texas,326,11765000,36088.95705521473,287,8039000,28010.452961672472,39,3726000
2022,county,48121,Denton,48183,Gregg,TX,Rural Texas,103,2506000,24330.09708737864,117,3454000,29521.36752136752,-14,-948000
2022,county,48085,Collin,48183,Gregg,TX,Rural Texas,95,3837000,40389.47368421053,91,2990000,32857.142857142855,4,847000
2022,county,48439,Tarrant,48187,Guadalupe,TX,San Antonio,75,2660000,35466.666666666664,116,4506000,38844.8275862069,-41,-1846000
2022,county,48113,Dallas,48187,Guadalupe,TX,San Antonio,69,2170000,31449.27536231884,80,2962000,37025.0,-11,-792000
2022,county,48121,Denton,48187,Guadalupe,TX,San Antonio,63,2497000,39634.920634920636,58,3389000,58431.03448275862,5,-892000
2022,county,48085,Collin,48187,Guadalupe,TX,San Antonio,46,2051000,44586.95652173913,51,1989000,39000.0,-5,62000
2022,county,48439,Tarrant,37081,Guilford,NC,Greensboro,91,2479000,27241.75824175824,54,1789000,33129.62962962963,37,690000
2022,county,48113,Dallas,37081,Guilford,NC,Greensboro,105,3606000,34342.857142857145,56,3296000,58857.142857142855,49,310000
2022,county,48439,Tarrant,13135,Gwinnett,GA,Atlanta,170,7257000,42688.23529411765,114,3549000,31131.57894736842,56,3708000
2022,county,48113,Dallas,13135,Gwinnett,GA,Atlanta,231,7675000,33225.108225108226,114,4692000,41157.89473684211,117,2983000
2022,county,48121,Denton,13135,Gwinnett,GA,Atlanta,90,3113000,34588.88888888889,101,3863000,38247.52475247525,-11,-750000
2022,county,48085,Collin,13135,Gwinnett,GA,Atlanta,165,6101000,36975.757575757576,84,2728000,32476.190476190477,81,3373000
2022,county,48439,Tarrant,39061,Hamilton,OH,Cincinnati,67,2980000,44477.611940298506,54,2045000,37870.37037037037,13,935000
2022,county,48439,Tarrant,47065,Hamilton,TN,Chattanooga,47,1507000,32063.82978723404,54,3023000,55981.48148148148,-7,-1516000
2022,county,48113,Dallas,39061,Hamilton,OH,Cincinnati,141,9478000,67219.85815602836,86,4560000,53023.25581395349,55,4918000
2022,county,48113,Dallas,18057,Hamilton,IN,Indianapolis,79,7195000,91075.9493670886,36,2132000,59222.22222222222,43,5063000
2022,county,48113,Dallas,47065,Hamilton,TN,Chattanooga,34,2566000,75470.58823529411,40,1795000,44875.0,-6,771000
2022,county,48121,Denton,39061,Hamilton,OH,Cincinnati,65,3634000,55907.692307692305,40,3095000,77375.0,25,539000
2022,county,48121,Denton,18057,Hamilton,IN,Indianapolis,61,4015000,65819.67213114754,39,4134000,106000.0,22,-119000
2022,county,48085,Collin,39061,Hamilton,OH,Cincinnati,83,3868000,46602.409638554214,42,2282000,54333.333333333336,41,1586000
2022,county,48085,Collin,18057,Hamilton,IN,Indianapolis,58,3618000,62379.31034482759,45,4028000,89511.11111111111,13,-410000
2022,county,48439,Tarrant,48201,Harris,TX,Houston,2210,104129000,47117.19457013575,1982,78741000,39728.05247225025,228,25388000
2022,county,48113,Dallas,48201,Harris,TX,Houston,3209,210148000,65487.06762231225,3079,148857000,48345.89152322183,130,61291000
2022,county,48121,Denton,48201,Harris,TX,Houston,1124,68290000,60756.22775800712,959,43097000,44939.52033368092,165,25193000
2022,county,48085,Collin,48201,Harris,TX,Houston,1385,80940000,58440.43321299639,1163,54348000,46730.868443680134,222,26592000
2022,county,48439,Tarrant,48203,Harrison,TX,Rural Texas,82,1785000,21768.29268292683,79,1901000,24063.291139240508,3,-116000
2022,county,48439,Tarrant,28047,Harrison,MS,Gulfport-Biloxi,68,1956000,28764.70588235294,54,1417000,26240.74074074074,14,539000
2022,county,48113,Dallas,48203,Harrison,TX,Rural Texas,106,3442000,32471.69811320755,115,3995000,34739.13043478261,-9,-553000
2022,county,48113,Dallas,28047,Harrison,MS,Gulfport-Biloxi,48,1114000,23208.333333333332,34,1053000,30970.58823529412,14,61000
2022,county,48085,Collin,48203,Harrison,TX,Rural Texas,34,4650000,136764.70588235295,58,2672000,46068.96551724138,-24,1978000
2022,county,48439,Tarrant,48209,Hays,TX,Austin,205,8361000,40785.365853658535,223,10257000,45995.51569506727,-18,-1896000
2022,county,48113,Dallas,48209,Hays,TX,Austin,198,7819000,39489.89898989899,298,22639000,75969.79865771811,-100,-14820000
2022,county,48121,Denton,48209,Hays,TX,Austin,129,4848000,37581.395348837206,138,6322000,45811.59420289855,-9,-1474000
2022,county,48085,Collin,48209,Hays,TX,Austin,129,5564000,43131.782945736435,158,13465000,85221.51898734177,-29,-7901000
2022,county,48439,Tarrant,48213,Henderson,TX,Rural Texas,137,5265000,38430.65693430657,298,14347000,48144.29530201342,-161,-9082000
2022,county,48113,Dallas,48213,Henderson,TX,Rural Texas,322,16528000,51329.19254658385,833,28607000,34342.1368547419,-511,-12079000
2022,county,48121,Denton,48213,Henderson,TX,Rural Texas,77,3757000,48792.207792207795,137,9468000,69109.48905109489,-60,-5711000
2022,county,48085,Collin,48213,Henderson,TX,Rural Texas,94,3254000,34617.02127659575,183,14315000,78224.043715847,-89,-11061000
2022,county,48439,Tarrant,27053,Hennepin,MN,Minneapolis,243,9960000,40987.654320987655,105,3730000,35523.80952380953,138,6230000
2022,county,48113,Dallas,27053,Hennepin,MN,Minneapolis,312,25975000,83253.20512820513,194,10755000,55438.14432989691,118,15220000
2022,county,48121,Denton,27053,Hennepin,MN,Minneapolis,220,15242000,69281.81818181818,75,3480000,46400.0,145,11762000
2022,county,48085,Collin,27053,Hennepin,MN,Minneapolis,386,23306000,60378.238341968914,102,4854000,47588.23529411765,284,18452000
2022,county,48113,Dallas,51087,Henrico,VA,Richmond,80,4965000,62062.5,41,1643000,40073.170731707316,39,3322000
2022,county,48121,Denton,51087,Henrico,VA,Richmond,39,2247000,57615.38461538462,39,2094000,53692.307692307695,0,153000
2022,county,48085,Collin,51087,Henrico,VA,Richmond,122,7687000,63008.19672131148,43,1501000,34906.976744186046,79,6186000
2022,county,48113,Dallas,13151,Henry,GA,Atlanta,35,606000,17314.285714285714,40,783000,19575.0,-5,-177000
2022,county,48439,Tarrant,48215,Hidalgo,TX,Rural Texas,287,7342000,25581.881533101045,256,8428000,32921.875,31,-1086000
2022,county,48113,Dallas,48215,Hidalgo,TX,Rural Texas,327,10005000,30596.330275229357,332,9590000,28885.5421686747,-5,415000
2022,county,48121,Denton,48215,Hidalgo,TX,Rural Texas,83,3592000,43277.10843373494,84,2387000,28416.666666666668,-1,1205000
2022,county,48085,Collin,48215,Hidalgo,TX,Rural Texas,113,4710000,41681.41592920354,115,5126000,44573.913043478264,-2,-416000
2022,county,48439,Tarrant,48217,Hill,TX,Rural Texas,191,6545000,34267.01570680628,390,12985000,33294.8717948718,-199,-6440000
2022,county,48113,Dallas,48217,Hill,TX,Rural Texas,58,963000,16603.44827586207,206,5651000,27432.038834951458,-148,-4688000
2022,county,48439,Tarrant,12057,Hillsborough,FL,Tampa,185,6287000,33983.78378378379,252,10863000,43107.142857142855,-67,-4576000
2022,county,48439,Tarrant,33011,Hillsborough,NH,Rural New Hampshire,54,1417000,26240.74074074074,53,2513000,47415.09433962264,1,-1096000
2022,county,48113,Dallas,12057,Hillsborough,FL,Tampa,314,18538000,59038.21656050955,336,18519000,55116.07142857143,-22,19000
2022,county,48121,Denton,12057,Hillsborough,FL,Tampa,122,5881000,48204.91803278688,142,7066000,49760.56338028169,-20,-1185000
2022,county,48085,Collin,12057,Hillsborough,FL,Tampa,211,18463000,87502.36966824645,208,12001000,57697.11538461538,3,6462000
2022,county,48439,Tarrant,28049,Hinds,MS,Jackson,270,3585000,13277.777777777777,105,1865000,17761.904761904763,165,1720000
2022,county,48113,Dallas,28049,Hinds,MS,Jackson,284,4871000,17151.408450704224,104,2149000,20663.46153846154,180,2722000
2022,county,48121,Denton,28049,Hinds,MS,Jackson,124,1380000,11129.032258064517,57,1021000,17912.280701754386,67,359000
2022,county,48085,Collin,28049,Hinds,MS,Jackson,94,1761000,18734.042553191488,47,775000,16489.36170212766,47,986000
2022,county,48439,Tarrant,15003,Honolulu,HI,Rural Hawaii,222,8399000,37833.333333333336,138,5035000,36485.50724637681,84,3364000
2022,county,48113,Dallas,15003,Honolulu,HI,Rural Hawaii,162,6801000,41981.48148148148,137,5076000,37051.09489051095,25,1725000
2022,county,48121,Denton,15003,Honolulu,HI,Rural Hawaii,165,5140000,31151.515151515152,63,3880000,61587.30158730159,102,1260000
2022,county,48085,Collin,15003,Honolulu,HI,Rural Hawaii,151,6354000,42079.470198675495,81,3538000,43679.01234567901,70,2816000
2022,county,48439,Tarrant,48221,Hood,TX,Rural Texas,661,21364000,32320.726172465962,1261,54273000,43039.651070578904,-600,-32909000
2022,county,48113,Dallas,48221,Hood,TX,Rural Texas,113,3987000,35283.18584070796,194,11639000,59994.845360824744,-81,-7652000
2022,county,48121,Denton,48221,Hood,TX,Rural Texas,97,4549000,46896.907216494845,179,10956000,61206.703910614524,-82,-6407000
2022,county,48085,Collin,48221,Hood,TX,Rural Texas,51,1574000,30862.745098039217,95,6019000,63357.89473684211,-44,-4445000
2022,county,48439,Tarrant,48223,Hopkins,TX,Rural Texas,37,1082000,29243.243243243243,67,2483000,37059.701492537315,-30,-1401000
2022,county,48113,Dallas,48223,Hopkins,TX,Rural Texas,91,3480000,38241.758241758245,173,7861000,45439.3063583815,-82,-4381000
2022,county,48085,Collin,48223,Hopkins,TX,Rural Texas,63,1292000,20507.93650793651,120,4595000,38291.666666666664,-57,-3303000
2022,county,48113,Dallas,24027,Howard,MD,Baltimore,71,4041000,56915.49295774648,36,2847000,79083.33333333333,35,1194000
2022,county,48085,Collin,24027,Howard,MD,Baltimore,116,7767000,66956.89655172414,37,2703000,73054.05405405405,79,5064000
2022,county,48439,Tarrant,34017,Hudson,NJ,New York,107,6528000,61009.345794392524,53,2253000,42509.43396226415,54,4275000
2022,county,48113,Dallas,34017,Hudson,NJ,New York,269,19242000,71531.59851301115,142,13889000,97809.85915492958,127,5353000
2022,county,48121,Denton,34017,Hudson,NJ,New York,109,7323000,67183.4862385321,33,2988000,90545.45454545454,76,4335000
2022,county,48085,Collin,34017,Hudson,NJ,New York,304,23422000,77046.05263157895,65,4867000,74876.92307692308,239,18555000
2022,county,48439,Tarrant,48231,Hunt,TX,Dallas-Fort Worth,206,5058000,24553.398058252427,399,10596000,26556.39097744361,-193,-5538000
2022,county,48113,Dallas,48231,Hunt,TX,Dallas-Fort Worth,794,22013000,27724.18136020151,2258,55128000,24414.52612931798,-1464,-33115000
2022,county,48121,Denton,48231,Hunt,TX,Dallas-Fort Worth,168,5207000,30994.04761904762,360,13097000,36380.555555555555,-192,-7890000
2022,county,48085,Collin,48231,Hunt,TX,Dallas-Fort Worth,701,24009000,34249.643366619115,1497,49170000,32845.69138276553,-796,-25161000
2022,county,48439,Tarrant,48237,Jack,TX,Rural Texas,35,1159000,33114.28571428572,91,3078000,33824.17582417582,-56,-1919000
2022,county,48439,Tarrant,29095,Jackson,MO,Kansas City,227,6860000,30220.264317180616,129,4987000,38658.91472868217,98,1873000
2022,county,48113,Dallas,29095,Jackson,MO,Kansas City,301,11129000,36973.4219269103,192,12496000,65083.333333333336,109,-1367000
2022,county,48121,Denton,29095,Jackson,MO,Kansas City,117,5324000,45504.27350427351,84,3544000,42190.47619047619,33,1780000
2022,county,48085,Collin,29095,Jackson,MO,Kansas City,110,3020000,27454.545454545456,63,2496000,39619.04761904762,47,524000
2022,county,48439,Tarrant,48245,Jefferson,TX,Rural Texas,164,4918000,29987.80487804878,93,1814000,19505.37634408602,71,3104000
2022,county,48439,Tarrant,08059,Jefferson,CO,Denver,129,6218000,48201.5503875969,152,8993000,59164.47368421053,-23,-2775000
2022,county,48439,Tarrant,21111,Jefferson,KY,Louisville,118,4523000,38330.50847457627,95,2752000,28968.42105263158,23,1771000
2022,county,48439,Tarrant,01073,Jefferson,AL,Birmingham,92,6477000,70402.17391304347,93,2429000,26118.279569892475,-1,4048000
2022,county,48439,Tarrant,05069,Jefferson,AR,Rural Arkansas,72,1094000,15194.444444444445,35,464000,13257.142857142857,37,630000
2022,county,48113,Dallas,01073,Jefferson,AL,Birmingham,197,9696000,49218.27411167513,78,3430000,43974.35897435898,119,6266000
2022,county,48113,Dallas,48245,Jefferson,TX,Rural Texas,154,3776000,24519.48051948052,109,2520000,23119.26605504587,45,1256000
2022,county,48113,Dallas,21111,Jefferson,KY,Louisville,129,9218000,71457.36434108527,94,4206000,44744.68085106383,35,5012000
2022,county,48113,Dallas,08059,Jefferson,CO,Denver,97,4341000,44752.57731958763,187,12285000,65695.1871657754,-90,-7944000
2022,county,48113,Dallas,05069,Jefferson,AR,Rural Arkansas,81,1328000,16395.061728395063,53,556000,10490.566037735849,28,772000
2022,county,48121,Denton,08059,Jefferson,CO,Denver,78,3477000,44576.92307692308,122,5565000,45614.75409836065,-44,-2088000
2022,county,48121,Denton,01073,Jefferson,AL,Birmingham,45,2146000,47688.88888888889,36,1914000,53166.666666666664,9,232000
2022,county,48085,Collin,08059,Jefferson,CO,Denver,120,5903000,49191.666666666664,94,7403000,78755.31914893616,26,-1500000
2022,county,48085,Collin,21111,Jefferson,KY,Louisville,136,6360000,46764.705882352944,47,1219000,25936.17021276596,89,5141000
2022,county,48085,Collin,01073,Jefferson,AL,Birmingham,51,2167000,42490.19607843137,35,1974000,56400.0,16,193000
2022,county,48439,Tarrant,22051,Jefferson Parish,LA,New Orleans,176,4424000,25136.363636363636,57,1416000,24842.105263157893,119,3008000
2022,county,48113,Dallas,22051,Jefferson Parish,LA,New Orleans,255,6718000,26345.098039215685,98,2350000,23979.591836734693,157,4368000
2022,county,48439,Tarrant,48251,Johnson,TX,Dallas-Fort Worth,3971,124153000,31264.920674892976,8114,274986000,33890.31303919152,-4143,-150833000
2022,county,48439,Tarrant,20091,Johnson,KS,Kansas City,133,11453000,86112.78195488722,142,6225000,43838.028169014084,-9,5228000
2022,county,48113,Dallas,48251,Johnson,TX,Dallas-Fort Worth,442,13003000,29418.552036199097,1176,35311000,30026.36054421769,-734,-22308000
2022,county,48113,Dallas,20091,Johnson,KS,Kansas City,235,11433000,48651.063829787236,167,12606000,75485.02994011976,68,-1173000
2022,county,48121,Denton,48251,Johnson,TX,Dallas-Fort Worth,221,7551000,34167.420814479636,274,12155000,44361.313868613135,-53,-4604000
2022,county,48121,Denton,20091,Johnson,KS,Kansas City,181,10152000,56088.39779005525,90,5025000,55833.333333333336,91,5127000
2022,county,48085,Collin,20091,Johnson,KS,Kansas City,341,21372000,62674.48680351906,91,5255000,57747.25274725275,250,16117000
2022,county,48085,Collin,48251,Johnson,TX,Dallas-Fort Worth,130,4194000,32261.53846153846,244,9964000,40836.065573770495,-114,-5770000
2022,county,48439,Tarrant,48253,Jones,TX,Rural Texas,28,674000,24071.428571428572,34,687000,20205.882352941175,-6,-13000
2022,county,48085,Collin,17089,Kane,IL,Chicago,72,3466000,48138.88888888889,47,2143000,45595.744680851065,25,1323000
2022,county,48439,Tarrant,48257,Kaufman,TX,Dallas-Fort Worth,464,13958000,30081.896551724138,1114,36294000,32579.892280071814,-650,-22336000
2022,county,48113,Dallas,48257,Kaufman,TX,Dallas-Fort Worth,3221,80521000,24998.758149642967,10888,288121000,26462.25202057311,-7667,-207600000
2022,county,48121,Denton,48257,Kaufman,TX,Dallas-Fort Worth,259,10319000,39841.69884169884,837,27340000,32664.277180406214,-578,-17021000
2022,county,48085,Collin,48257,Kaufman,TX,Dallas-Fort Worth,619,20238000,32694.668820678515,1200,45845000,38204.166666666664,-581,-25607000
2022,county,48113,Dallas,48259,Kendall,TX,Rural Texas,28,1388000,49571.42857142857,47,8362000,177914.89361702127,-19,-6974000
2022,county,48439,Tarrant,26081,Kent,MI,Rural Michigan,104,2530000,24326.923076923078,79,2218000,28075.949367088608,25,312000
2022,county,48113,Dallas,26081,Kent,MI,Rural Michigan,96,3669000,38218.75,44,1801000,40931.818181818184,52,1868000
2022,county,48121,Denton,26081,Kent,MI,Rural Michigan,46,2064000,44869.565217391304,28,1721000,61464.28571428572,18,343000
2022,county,48439,Tarrant,06029,Kern,CA,Rural California,197,6476000,32873.09644670051,70,1658000,23685.714285714286,127,4818000
2022,county,48113,Dallas,06029,Kern,CA,Rural California,97,2736000,28206.18556701031,53,1434000,27056.603773584906,44,1302000
2022,county,48439,Tarrant,48265,Kerr,TX,Rural Texas,33,1390000,42121.21212121212,39,1614000,41384.61538461538,-6,-224000
2022,county,48113,Dallas,48265,Kerr,TX,Rural Texas,38,1186000,31210.526315789473,60,3524000,58733.333333333336,-22,-2338000
2022,county,48439,Tarrant,53033,King,WA,Seattle,512,35852000,70023.4375,400,28290000,70725.0,112,7562000
2022,county,48113,Dallas,53033,King,WA,Seattle,569,49701000,87347.97891036907,652,55619000,85305.21472392639,-83,-5918000
2022,county,48121,Denton,53033,King,WA,Seattle,515,47891000,92992.23300970874,279,19203000,68827.95698924731,236,28688000
2022,county,48085,Collin,53033,King,WA,Seattle,998,104199000,104407.81563126252,536,53052000,98977.6119402985,462,51147000
2022,county,48439,Tarrant,36047,Kings,NY,New York,234,10641000,45474.35897435898,100,4632000,46320.0,134,6009000
2022,county,48113,Dallas,36047,Kings,NY,New York,336,24749000,73657.73809523809,234,15852000,67743.58974358975,102,8897000
2022,county,48121,Denton,36047,Kings,NY,New York,156,7005000,44903.846153846156,62,2976000,48000.0,94,4029000
2022,county,48085,Collin,36047,Kings,NY,New York,287,13145000,45801.393728222996,100,6216000,62160.0,187,6929000
2022,county,48439,Tarrant,53035,Kitsap,WA,Rural Washington,78,2561000,32833.333333333336,68,1341000,19720.58823529412,10,1220000
2022,county,48113,Dallas,53035,Kitsap,WA,Rural Washington,43,1493000,34720.93023255814,47,4077000,86744.68085106384,-4,-2584000
2022,county,48439,Tarrant,47093,Knox,TN,Knoxville,41,1197000,29195.121951219513,72,3771000,52375.0,-31,-2574000
2022,county,48113,Dallas,47093,Knox,TN,Knoxville,37,1351000,36513.51351351351,55,3121000,56745.454545454544,-18,-1770000
2022,county,48085,Collin,47093,Knox,TN,Knoxville,58,3797000,65465.51724137931,37,1467000,39648.64864864865,21,2330000
2022,county,48439,Tarrant,22055,Lafayette Parish,LA,Rural Louisiana,70,2859000,40842.857142857145,60,2524000,42066.666666666664,10,335000
2022,county,48113,Dallas,22055,Lafayette Parish,LA,Rural Louisiana,119,3443000,28932.7731092437,67,2944000,43940.298507462685,52,499000
2022,county,48085,Collin,22055,Lafayette Parish,LA,Rural Louisiana,57,2274000,39894.73684210526,44,2091000,47522.72727272727,13,183000
2022,county,48439,Tarrant,17097,Lake,IL,Chicago,135,10840000,80296.29629629629,66,2113000,32015.151515151516,69,8727000
2022,county,48439,Tarrant,18089,Lake,IN,Rural Indiana,95,3107000,32705.263157894737,34,1420000,41764.705882352944,61,1687000
2022,county,48439,Tarrant,12069,Lake,FL,Orlando,50,1720000,34400.0,63,2773000,44015.87301587302,-13,-1053000
2022,county,48113,Dallas,17097,Lake,IL,Chicago,166,10307000,62090.361445783135,83,8072000,97253.01204819277,83,2235000
2022,county,48113,Dallas,18089,Lake,IN,Rural Indiana,72,1721000,23902.777777777777,35,741000,21171.428571428572,37,980000
2022,county,48113,Dallas,12069,Lake,FL,Orlando,26,989000,38038.46153846154,36,2103000,58416.666666666664,-10,-1114000
2022,county,48439,Tarrant,48277,Lamar,TX,Rural Texas,63,1390000,22063.492063492064,82,2165000,26402.439024390245,-19,-775000
2022,county,48113,Dallas,48277,Lamar,TX,Rural Texas,108,2557000,23675.925925925927,146,5178000,35465.75342465754,-38,-2621000
2022,county,48121,Denton,48277,Lamar,TX,Rural Texas,53,754000,14226.415094339623,74,2444000,33027.02702702703,-21,-1690000
2022,county,48085,Collin,48277,Lamar,TX,Rural Texas,83,2442000,29421.68674698795,125,3350000,26800.0,-42,-908000
2022,county,48439,Tarrant,31109,Lancaster,NE,Rural Nebraska,60,2609000,43483.333333333336,40,1827000,45675.0,20,782000
2022,county,48113,Dallas,31109,Lancaster,NE,Rural Nebraska,58,2259000,38948.275862068964,54,2084000,38592.59259259259,4,175000
2022,county,48439,Tarrant,41039,Lane,OR,Rural Oregon,55,1672000,30400.0,36,1584000,44000.0,19,88000
2022,county,48113,Dallas,41039,Lane,OR,Rural Oregon,32,790000,24687.5,32,1316000,41125.0,0,-526000
2022,county,48439,Tarrant,08069,Larimer,CO,Rural Colorado,68,2932000,43117.64705882353,113,7312000,64707.96460176991,-45,-4380000
2022,county,48113,Dallas,08069,Larimer,CO,Rural Colorado,47,1791000,38106.382978723406,97,6583000,67865.97938144329,-50,-4792000
2022,county,48121,Denton,08069,Larimer,CO,Rural Colorado,42,1597000,38023.80952380953,80,4449000,55612.5,-38,-2852000
2022,county,48085,Collin,08069,Larimer,CO,Rural Colorado,54,2265000,41944.444444444445,94,7706000,81978.72340425532,-40,-5441000
2022,county,48439,Tarrant,12071,Lee,FL,S.W. Florida,108,3969000,36750.0,133,6959000,52323.308270676695,-25,-2990000
2022,county,48113,Dallas,12071,Lee,FL,S.W. Florida,89,5417000,60865.168539325845,127,9646000,75952.75590551182,-38,-4229000
2022,county,48121,Denton,12071,Lee,FL,S.W. Florida,39,2159000,55358.97435897436,76,5009000,65907.8947368421,-37,-2850000
2022,county,48085,Collin,12071,Lee,FL,S.W. Florida,60,2783000,46383.333333333336,77,6757000,87753.24675324676,-17,-3974000
2022,county,48439,Tarrant,48293,Limestone,TX,Rural Texas,47,909000,19340.425531914894,49,1172000,23918.367346938776,-2,-263000
2022,county,48113,Dallas,48293,Limestone,TX,Rural Texas,32,606000,18937.5,69,1615000,23405.797101449276,-37,-1009000
2022,county,48113,Dallas,22061,Lincoln Parish,LA,Rural Louisiana,69,1508000,21855.072463768116,51,1356000,26588.235294117647,18,152000
2022,county,48439,Tarrant,06037,Los Angeles,CA,Los Angeles,2054,88578000,43124.634858812075,720,34081000,47334.72222222222,1334,54497000
2022,county,48113,Dallas,06037,Los Angeles,CA,Los Angeles,2031,259676000,127856.22845888724,1081,68559000,63421.8316373728,950,191117000
2022,county,48121,Denton,06037,Los Angeles,CA,Los Angeles,1330,76073000,57197.74436090225,364,21099000,57964.28571428572,966,54974000
2022,county,48085,Collin,06037,Los Angeles,CA,Los Angeles,2048,104326000,50940.4296875,446,29060000,65156.95067264574,1602,75266000
2022,county,48439,Tarrant,51107,Loudoun,VA,Rural Virginia,90,5059000,56211.11111111111,43,2904000,67534.88372093023,47,2155000
2022,county,48113,Dallas,51107,Loudoun,VA,Rural Virginia,113,5924000,52424.77876106195,54,3539000,65537.03703703704,59,2385000
2022,county,48121,Denton,51107,Loudoun,VA,Rural Virginia,91,8000000,87912.08791208791,55,3192000,58036.36363636364,36,4808000
2022,county,48085,Collin,51107,Loudoun,VA,Rural Virginia,170,10088000,59341.17647058824,77,5925000,76948.05194805194,93,4163000
2022,county,48439,Tarrant,48303,Lubbock,TX,Rural Texas,548,17425000,31797.445255474453,369,10391000,28159.89159891599,179,7034000
2022,county,48113,Dallas,48303,Lubbock,TX,Rural Texas,493,17772000,36048.68154158215,357,20057000,56182.072829131655,136,-2285000
2022,county,48121,Denton,48303,Lubbock,TX,Rural Texas,319,13632000,42733.54231974921,202,10411000,51539.60396039604,117,3221000
2022,county,48085,Collin,48303,Lubbock,TX,Rural Texas,302,9754000,32298.01324503311,208,9359000,44995.192307692305,94,395000
2022,county,48439,Tarrant,39095,Lucas,OH,Rural Ohio,53,834000,15735.849056603774,41,1575000,38414.634146341465,12,-741000
2022,county,48439,Tarrant,26099,Macomb,MI,Rural Michigan,111,2773000,24981.981981981982,58,1598000,27551.724137931036,53,1175000
2022,county,48113,Dallas,26099,Macomb,MI,Rural Michigan,79,2847000,36037.9746835443,34,1771000,52088.23529411765,45,1076000
2022,county,48121,Denton,26099,Macomb,MI,Rural Michigan,42,1509000,35928.57142857143,45,1090000,24222.222222222223,-3,419000
2022,county,48439,Tarrant,01089,Madison,AL,Huntsville,89,3568000,40089.88764044944,83,3886000,46819.27710843374,6,-318000
2022,county,48113,Dallas,01089,Madison,AL,Huntsville,59,2881000,48830.50847457627,77,4221000,54818.181818181816,-18,-1340000
2022,county,48439,Tarrant,12081,Manatee,FL,Rural Florida,40,1616000,40400.0,82,4731000,57695.12195121951,-42,-3115000
2022,county,48113,Dallas,12081,Manatee,FL,Rural Florida,56,2364000,42214.28571428572,72,4497000,62458.333333333336,-16,-2133000
2022,county,48121,Denton,12081,Manatee,FL,Rural Florida,50,2373000,47460.0,68,3658000,53794.117647058825,-18,-1285000
2022,county,48085,Collin,12081,Manatee,FL,Rural Florida,41,2563000,62512.19512195122,49,4309000,87938.77551020408,-8,-1746000
2022,county,48439,Tarrant,04013,Maricopa,AZ,Phoenix,949,49884000,52564.805057955746,673,42953000,63823.179791976225,276,6931000
2022,county,48113,Dallas,04013,Maricopa,AZ,Phoenix,955,195171000,204367.5392670157,804,79092000,98373.13432835821,151,116079000
2022,county,48121,Denton,04013,Maricopa,AZ,Phoenix,689,65207000,94640.05805515239,459,29481000,64228.75816993464,230,35726000
2022,county,48085,Collin,04013,Maricopa,AZ,Phoenix,799,42463000,53145.18147684606,506,34603000,68385.37549407115,293,7860000
2022,county,48439,Tarrant,18097,Marion,IN,Indianapolis,218,6269000,28756.880733944956,89,4227000,47494.38202247191,129,2042000
2022,county,48113,Dallas,18097,Marion,IN,Indianapolis,259,8505000,32837.83783783784,166,5326000,32084.33734939759,93,3179000
2022,county,48085,Collin,18097,Marion,IN,Indianapolis,122,4662000,38213.11475409836,36,1393000,38694.444444444445,86,3269000
2022,county,48439,Tarrant,17111,McHenry,IL,Chicago,48,2016000,42000.0,35,1901000,54314.28571428572,13,115000
2022,county,48439,Tarrant,48309,McLennan,TX,Rural Texas,607,24884000,40995.05766062603,490,16780000,34244.897959183676,117,8104000
2022,county,48113,Dallas,48309,McLennan,TX,Rural Texas,483,27284000,56488.61283643892,425,15558000,36607.05882352941,58,11726000
2022,county,48121,Denton,48309,McLennan,TX,Rural Texas,191,6681000,34979.05759162304,154,5528000,35896.103896103894,37,1153000
2022,county,48085,Collin,48309,McLennan,TX,Rural Texas,179,6789000,37927.374301675976,143,5430000,37972.02797202797,36,1359000
2022,county,48439,Tarrant,37119,Mecklenburg,NC,Charlotte,180,7536000,41866.666666666664,140,8171000,58364.28571428572,40,-635000
2022,county,48113,Dallas,37119,Mecklenburg,NC,Charlotte,391,24714000,63207.16112531969,299,20377000,68150.5016722408,92,4337000
2022,county,48121,Denton,37119,Mecklenburg,NC,Charlotte,121,13977000,115512.39669421487,97,7530000,77628.86597938144,24,6447000
2022,county,48085,Collin,37119,Mecklenburg,NC,Charlotte,266,16054000,60353.38345864662,156,10447000,66967.94871794872,110,5607000
2022,county,48113,Dallas,34021,Mercer,NJ,Rural New Jersey,57,4932000,86526.31578947368,38,1774000,46684.21052631579,19,3158000
2022,county,48439,Tarrant,12086,Miami-Dade,FL,Miami,342,13608000,39789.47368421053,197,6666000,33837.56345177665,145,6942000
2022,county,48113,Dallas,12086,Miami-Dade,FL,Miami,544,29854000,54878.67647058824,379,34006000,89725.59366754617,165,-4152000
2022,county,48121,Denton,12086,Miami-Dade,FL,Miami,211,8069000,38241.70616113744,115,4791000,41660.86956521739,96,3278000
2022,county,48085,Collin,12086,Miami-Dade,FL,Miami,237,9718000,41004.2194092827,178,13294000,74685.39325842696,59,-3576000
2022,county,48439,Tarrant,25017,Middlesex,MA,Boston,129,9311000,72178.2945736434,91,5075000,55769.230769230766,38,4236000
2022,county,48439,Tarrant,34023,Middlesex,NJ,New York,83,4552000,54843.3734939759,32,1085000,33906.25,51,3467000
2022,county,48113,Dallas,25017,Middlesex,MA,Boston,251,18036000,71856.57370517928,215,18900000,87906.97674418605,36,-864000
2022,county,48113,Dallas,34023,Middlesex,NJ,New York,305,15755000,51655.737704918036,72,3478000,48305.555555555555,233,12277000
2022,county,48121,Denton,34023,Middlesex,NJ,New York,240,17030000,70958.33333333333,60,2480000,41333.333333333336,180,14550000
2022,county,48121,Denton,25017,Middlesex,MA,Boston,146,10573000,72417.80821917808,74,4416000,59675.67567567567,72,6157000
2022,county,48085,Collin,34023,Middlesex,NJ,New York,715,39516000,55267.13286713287,71,3729000,52521.126760563384,644,35787000
2022,county,48085,Collin,25017,Middlesex,MA,Boston,284,19348000,68126.76056338029,102,5795000,56813.72549019608,182,13553000
2022,county,48439,Tarrant,48329,Midland,TX,Rural Texas,381,31396000,82404.19947506562,309,10157000,32870.550161812294,72,21239000
2022,county,48113,Dallas,48329,Midland,TX,Rural Texas,274,14210000,51861.313868613135,169,5808000,34366.863905325445,105,8402000
2022,county,48121,Denton,48329,Midland,TX,Rural Texas,166,7711000,46451.80722891566,85,4669000,54929.41176470588,81,3042000
2022,county,48085,Collin,48329,Midland,TX,Rural Texas,159,8869000,55779.874213836476,80,4389000,54862.5,79,4480000
2022,county,48113,Dallas,05091,Miller,AR,Rural Arkansas,67,1042000,15552.23880597015,40,402000,10050.0,27,640000
2022,county,48439,Tarrant,55079,Milwaukee,WI,Milwaukee,289,8079000,27955.017301038064,115,2185000,19000.0,174,5894000
2022,county,48113,Dallas,55079,Milwaukee,WI,Milwaukee,304,28553000,93924.34210526316,131,3953000,30175.57251908397,173,24600000
2022,county,48121,Denton,55079,Milwaukee,WI,Milwaukee,96,3657000,38093.75,41,1340000,32682.926829268294,55,2317000
2022,county,48085,Collin,55079,Milwaukee,WI,Milwaukee,127,4395000,34606.299212598424,53,1391000,26245.283018867925,74,3004000
2022,county,48439,Tarrant,01097,Mobile,AL,Mobile,58,2650000,45689.65517241379,41,1523000,37146.34146341463,17,1127000
2022,county,48113,Dallas,01097,Mobile,AL,Mobile,113,4321000,38238.93805309734,55,1999000,36345.454545454544,58,2322000
2022,county,48439,Tarrant,36055,Monroe,NY,Rochester,40,1823000,45575.0,39,980000,25128.20512820513,1,843000
2022,county,48113,Dallas,36055,Monroe,NY,Rochester,80,4121000,51512.5,51,2179000,42725.490196078434,29,1942000
2022,county,48085,Collin,36055,Monroe,NY,Rochester,57,2844000,49894.73684210526,51,1600000,31372.549019607843,6,1244000
2022,county,48439,Tarrant,48337,Montague,TX,Rural Texas,78,6881000,88217.94871794872,277,10137000,36595.6678700361,-199,-3256000
2022,county,48121,Denton,48337,Montague,TX,Rural Texas,87,4316000,49609.19540229885,245,19821000,80902.04081632652,-158,-15505000
2022,county,48113,Dallas,06053,Monterey,CA,Rural California,52,3553000,68326.92307692308,39,2398000,61487.179487179485,13,1155000
2022,county,48439,Tarrant,48339,Montgomery,TX,Houston,363,20944000,57696.969696969696,570,27677000,48556.14035087719,-207,-6733000
2022,county,48439,Tarrant,24031,Montgomery,MD,D.C.,112,7334000,65482.142857142855,57,4993000,87596.49122807017,55,2341000
2022,county,48439,Tarrant,39113,Montgomery,OH,Rural Ohio,74,2359000,31878.37837837838,68,1319000,19397.058823529413,6,1040000
2022,county,48439,Tarrant,47125,Montgomery,TN,Rural Tennessee,58,1483000,25568.96551724138,83,3444000,41493.97590361446,-25,-1961000
2022,county,48113,Dallas,48339,Montgomery,TX,Houston,354,35643000,100686.44067796611,439,27651000,62986.33257403189,-85,7992000
2022,county,48113,Dallas,24031,Montgomery,MD,D.C.,217,21521000,99175.11520737327,132,6135000,46477.27272727273,85,15386000
2022,county,48113,Dallas,42091,Montgomery,PA,Philadelphia,84,7641000,90964.28571428571,53,2616000,49358.49056603773,31,5025000
2022,county,48113,Dallas,39113,Montgomery,OH,Rural Ohio,76,2416000,31789.473684210527,46,1089000,23673.91304347826,30,1327000
2022,county,48113,Dallas,47125,Montgomery,TN,Rural Tennessee,55,1392000,25309.090909090908,52,1223000,23519.23076923077,3,169000
2022,county,48121,Denton,48339,Montgomery,TX,Houston,285,12897000,45252.63157894737,306,18566000,60673.202614379086,-21,-5669000
2022,county,48121,Denton,24031,Montgomery,MD,D.C.,107,7411000,69261.68224299066,45,1912000,42488.88888888889,62,5499000
2022,county,48085,Collin,48339,Montgomery,TX,Houston,285,17275000,60614.0350877193,332,18470000,55632.530120481926,-47,-1195000
2022,county,48085,Collin,24031,Montgomery,MD,D.C.,139,7868000,56604.31654676259,60,3148000,52466.666666666664,79,4720000
2022,county,48113,Dallas,34027,Morris,NJ,New York,75,5344000,71253.33333333333,45,2757000,61266.666666666664,30,2587000
2022,county,48439,Tarrant,41051,Multnomah,OR,Portland,112,6008000,53642.857142857145,92,2646000,28760.869565217392,20,3362000
2022,county,48113,Dallas,41051,Multnomah,OR,Portland,159,14180000,89182.38993710691,117,5728000,48957.26495726496,42,8452000
2022,county,48121,Denton,41051,Multnomah,OR,Portland,66,3016000,45696.969696969696,29,1877000,64724.137931034486,37,1139000
2022,county,48085,Collin,41051,Multnomah,OR,Portland,79,4525000,57278.48101265823,51,3230000,63333.333333333336,28,1295000
2022,county,48439,Tarrant,48347,Nacogdoches,TX,Rural Texas,52,1069000,20557.69230769231,61,2752000,45114.75409836065,-9,-1683000
2022,county,48113,Dallas,48347,Nacogdoches,TX,Rural Texas,124,2338000,18854.83870967742,72,3233000,44902.77777777778,52,-895000
2022,county,48085,Collin,48347,Nacogdoches,TX,Rural Texas,59,1818000,30813.5593220339,31,1309000,42225.8064516129,28,509000
2022,county,48113,Dallas,36059,Nassau,NY,New York,175,11830000,67600.0,48,2156000,44916.666666666664,127,9674000
2022,county,48439,Tarrant,48349,Navarro,TX,Rural Texas,165,5176000,31369.696969696968,262,8457000,32278.625954198473,-97,-3281000
2022,county,48113,Dallas,48349,Navarro,TX,Rural Texas,290,8407000,28989.655172413793,626,16149000,25797.124600638977,-336,-7742000
2022,county,48121,Denton,48349,Navarro,TX,Rural Texas,41,866000,21121.951219512193,73,3126000,42821.91780821918,-32,-2260000
2022,county,48085,Collin,48349,Navarro,TX,Rural Texas,46,2203000,47891.30434782609,59,3759000,63711.86440677966,-13,-1556000
2022,county,48439,Tarrant,10003,New Castle,DE,Rural Delaware,58,2920000,50344.8275862069,56,1756000,31357.14285714286,2,1164000
2022,county,48113,Dallas,10003,New Castle,DE,Rural Delaware,127,5875000,46259.84251968504,64,2417000,37765.625,63,3458000
2022,county,48085,Collin,10003,New Castle,DE,Rural Delaware,112,5919000,52848.21428571428,37,1945000,52567.56756756757,75,3974000
2022,county,48439,Tarrant,36061,New York,NY,New York,151,12642000,83721.85430463577,122,15932000,130590.16393442624,29,-3290000
2022,county,48113,Dallas,36061,New York,NY,New York,479,108674000,226876.8267223382,546,59706000,109351.64835164836,-67,48968000
2022,county,48121,Denton,36061,New York,NY,New York,77,8455000,109805.1948051948,74,6247000,84418.91891891892,3,2208000
2022,county,48085,Collin,36061,New York,NY,New York,150,19104000,127360.0,159,20328000,127849.05660377358,-9,-1224000
2022,county,48113,Dallas,25021,Norfolk,MA,Boston,130,8743000,67253.84615384616,63,4345000,68968.25396825396,67,4398000
2022,county,48085,Collin,25021,Norfolk,MA,Boston,127,7379000,58102.362204724406,31,2998000,96709.67741935483,96,4381000
2022,county,48439,Tarrant,51710,Norfolk city,VA,Hampton Roads,96,2936000,30583.333333333332,41,1195000,29146.341463414636,55,1741000
2022,county,48113,Dallas,51710,Norfolk city,VA,Hampton Roads,55,1732000,31490.909090909092,34,1250000,36764.705882352944,21,482000
2022,county,48439,Tarrant,48355,Nueces,TX,Rural Texas,245,9823000,40093.87755102041,230,9001000,39134.782608695656,15,822000
2022,county,48113,Dallas,48355,Nueces,TX,Rural Texas,221,15459000,69950.2262443439,156,7114000,45602.5641025641,65,8345000
2022,county,48121,Denton,48355,Nueces,TX,Rural Texas,125,5262000,42096.0,88,3407000,38715.90909090909,37,1855000
2022,county,48085,Collin,48355,Nueces,TX,Rural Texas,129,6939000,53790.6976744186,50,2323000,46460.0,79,4616000
2022,county,48439,Tarrant,26125,Oakland,MI,Detroit,180,6829000,37938.88888888889,124,8691000,70088.70967741935,56,-1862000
2022,county,48113,Dallas,26125,Oakland,MI,Detroit,256,15640000,61093.75,125,8554000,68432.0,131,7086000
2022,county,48121,Denton,26125,Oakland,MI,Detroit,205,13118000,63990.243902439026,45,2611000,58022.22222222222,160,10507000
2022,county,48085,Collin,26125,Oakland,MI,Detroit,345,17191000,49828.985507246376,102,5376000,52705.882352941175,243,11815000
2022,county,48439,Tarrant,12091,Okaloosa,FL,FL Panhandle,64,2513000,39265.625,55,2777000,50490.90909090909,9,-264000
2022,county,48113,Dallas,12091,Okaloosa,FL,FL Panhandle,42,1857000,44214.28571428572,58,2706000,46655.1724137931,-16,-849000
2022,county,48439,Tarrant,40109,Oklahoma,OK,Oklahoma City,487,16830000,34558.52156057495,520,25223000,48505.769230769234,-33,-8393000
2022,county,48113,Dallas,40109,Oklahoma,OK,Oklahoma City,617,33854000,54868.71961102107,554,30422000,54913.35740072202,63,3432000
2022,county,48121,Denton,40109,Oklahoma,OK,Oklahoma City,339,15029000,44333.333333333336,283,12811000,45268.55123674912,56,2218000
2022,county,48085,Collin,40109,Oklahoma,OK,Oklahoma City,348,13578000,39017.24137931035,248,13349000,53826.6129032258,100,229000
2022,county,48439,Tarrant,37133,Onslow,NC,Rural North Carolina,126,2676000,21238.095238095237,87,2309000,26540.22988505747,39,367000
2022,county,48113,Dallas,37133,Onslow,NC,Rural North Carolina,69,1419000,20565.217391304348,44,1051000,23886.363636363636,25,368000
2022,county,48439,Tarrant,06059,Orange,CA,Los Angeles,987,86502000,87641.33738601823,268,16508000,61597.014925373136,719,69994000
2022,county,48439,Tarrant,12095,Orange,FL,Orlando,215,8373000,38944.186046511626,319,22280000,69843.26018808778,-104,-13907000
2022,county,48113,Dallas,06059,Orange,CA,Los Angeles,764,66119000,86543.19371727749,395,40611000,102812.65822784811,369,25508000
2022,county,48113,Dallas,12095,Orange,FL,Orlando,785,48024000,61177.07006369427,223,14061000,63053.81165919283,562,33963000
2022,county,48121,Denton,06059,Orange,CA,Los Angeles,1043,76750000,73585.81016299137,202,11816000,58495.0495049505,841,64934000
2022,county,48121,Denton,12095,Orange,FL,Orlando,138,5377000,38963.76811594203,160,6292000,39325.0,-22,-915000
2022,county,48085,Collin,06059,Orange,CA,Los Angeles,1256,114559000,91209.3949044586,260,20005000,76942.30769230769,996,94554000
2022,county,48085,Collin,12095,Orange,FL,Orlando,153,5591000,36542.48366013072,135,7277000,53903.7037037037,18,-1686000
2022,county,48439,Tarrant,22071,Orleans Parish,LA,New Orleans,148,3975000,26858.108108108107,87,2605000,29942.528735632182,61,1370000
2022,county,48113,Dallas,22071,Orleans Parish,LA,New Orleans,306,11329000,37022.875816993466,150,4767000,31780.0,156,6562000
2022,county,48085,Collin,22071,Orleans Parish,LA,New Orleans,84,2627000,31273.809523809523,38,1194000,31421.052631578947,46,1433000
2022,county,48439,Tarrant,12097,Osceola,FL,Orlando,55,1261000,22927.272727272728,68,2034000,29911.764705882353,-13,-773000
2022,county,48113,Dallas,12097,Osceola,FL,Orlando,51,2270000,44509.80392156863,56,2053000,36660.71428571428,-5,217000
2022,county,48439,Tarrant,22073,Ouachita Parish,LA,Rural Louisiana,293,4319000,14740.614334470989,114,1585000,13903.508771929824,179,2734000
2022,county,48113,Dallas,22073,Ouachita Parish,LA,Rural Louisiana,326,5016000,15386.503067484662,173,3428000,19815.028901734106,153,1588000
2022,county,48121,Denton,22073,Ouachita Parish,LA,Rural Louisiana,123,2671000,21715.447154471545,43,1257000,29232.558139534885,80,1414000
2022,county,48439,Tarrant,12099,Palm Beach,FL,Miami,176,10451000,59380.681818181816,136,10426000,76661.76470588235,40,25000
2022,county,48113,Dallas,12099,Palm Beach,FL,Miami,250,26736000,106944.0,203,21989000,108320.19704433497,47,4747000
2022,county,48121,Denton,12099,Palm Beach,FL,Miami,96,8487000,88406.25,126,10641000,84452.38095238095,-30,-2154000
2022,county,48085,Collin,12099,Palm Beach,FL,Miami,170,10335000,60794.117647058825,134,10421000,77768.65671641791,36,-86000
2022,county,48439,Tarrant,48363,Palo Pinto,TX,Rural Texas,151,6443000,42668.87417218543,338,18309000,54168.63905325444,-187,-11866000
2022,county,48439,Tarrant,48367,Parker,TX,Dallas-Fort Worth,3146,122865000,39054.35473617292,6416,283315000,44157.57481296758,-3270,-160450000
2022,county,48113,Dallas,48367,Parker,TX,Dallas-Fort Worth,217,8160000,37603.6866359447,368,25432000,69108.69565217392,-151,-17272000
2022,county,48121,Denton,48367,Parker,TX,Dallas-Fort Worth,252,10170000,40357.142857142855,665,32530000,48917.29323308271,-413,-22360000
2022,county,48085,Collin,48367,Parker,TX,Dallas-Fort Worth,99,3681000,37181.818181818184,245,13253000,54093.87755102041,-146,-9572000
2022,county,48439,Tarrant,12101,Pasco,FL,Tampa,46,916000,19913.043478260868,113,3925000,34734.513274336285,-67,-3009000
2022,county,48113,Dallas,12101,Pasco,FL,Tampa,55,2990000,54363.63636363636,84,5464000,65047.619047619046,-29,-2474000
2022,county,48121,Denton,12101,Pasco,FL,Tampa,41,1549000,37780.48780487805,60,2661000,44350.0,-19,-1112000
2022,county,48085,Collin,12101,Pasco,FL,Tampa,53,2035000,38396.22641509434,66,3031000,45924.242424242424,-13,-996000
2022,county,48439,Tarrant,40119,Payne,OK,Rural Oklahoma,37,1045000,28243.243243243243,51,1973000,38686.27450980392,-14,-928000
2022,county,48113,Dallas,40119,Payne,OK,Rural Oklahoma,40,1338000,33450.0,35,849000,24257.14285714286,5,489000
2022,county,48439,Tarrant,42101,Philadelphia,PA,Philadelphia,115,3435000,29869.565217391304,75,3173000,42306.666666666664,40,262000
2022,county,48113,Dallas,42101,Philadelphia,PA,Philadelphia,206,13062000,63407.76699029126,125,6393000,51144.0,81,6669000
2022,county,48121,Denton,42101,Philadelphia,PA,Philadelphia,47,1675000,35638.29787234042,23,2104000,91478.26086956522,24,-429000
2022,county,48085,Collin,42101,Philadelphia,PA,Philadelphia,106,5500000,51886.79245283019,33,1127000,34151.51515151515,73,4373000
2022,county,48439,Tarrant,53053,Pierce,WA,Seattle,267,9278000,34749.06367041198,128,6028000,47093.75,139,3250000
2022,county,48113,Dallas,53053,Pierce,WA,Seattle,143,4658000,32573.426573426572,98,4373000,44622.448979591834,45,285000
2022,county,48121,Denton,53053,Pierce,WA,Seattle,175,6322000,36125.71428571428,83,4006000,48265.06024096385,92,2316000
2022,county,48085,Collin,53053,Pierce,WA,Seattle,179,5454000,30469.273743016758,63,4117000,65349.206349206346,116,1337000
2022,county,48439,Tarrant,04019,Pima,AZ,Tucson,218,9266000,42504.5871559633,161,7479000,46453.416149068325,57,1787000
2022,county,48113,Dallas,04019,Pima,AZ,Tucson,171,7411000,43339.181286549705,121,6780000,56033.05785123967,50,631000
2022,county,48121,Denton,04019,Pima,AZ,Tucson,86,4328000,50325.58139534884,63,2654000,42126.98412698413,23,1674000
2022,county,48085,Collin,04019,Pima,AZ,Tucson,169,10469000,61946.74556213018,91,4706000,51714.28571428572,78,5763000
2022,county,48439,Tarrant,04021,Pinal,AZ,Phoenix,66,2746000,41606.06060606061,63,2189000,34746.031746031746,3,557000
2022,county,48113,Dallas,04021,Pinal,AZ,Phoenix,44,1511000,34340.90909090909,43,2640000,61395.348837209305,1,-1129000
2022,county,48439,Tarrant,12103,Pinellas,FL,Tampa,85,5419000,63752.94117647059,140,8634000,61671.42857142857,-55,-3215000
2022,county,48113,Dallas,12103,Pinellas,FL,Tampa,94,5829000,62010.63829787234,143,11426000,79902.0979020979,-49,-5597000
2022,county,48121,Denton,12103,Pinellas,FL,Tampa,66,5647000,85560.60606060606,88,6330000,71931.81818181818,-22,-683000
2022,county,48085,Collin,12103,Pinellas,FL,Tampa,69,3620000,52463.76811594203,76,5327000,70092.1052631579,-7,-1707000
2022,county,48439,Tarrant,06061,Placer,CA,Sacramento,111,12909000,116297.2972972973,43,1429000,33232.558139534885,68,11480000
2022,county,48439,Tarrant,29165,Platte,MO,Kansas City,51,1793000,35156.86274509804,43,2033000,47279.06976744186,8,-240000
2022,county,48439,Tarrant,19153,Polk,IA,Rural Iowa,78,2837000,36371.794871794875,43,942000,21906.976744186046,35,1895000
2022,county,48439,Tarrant,12105,Polk,FL,Orlando,73,1937000,26534.246575342466,123,3400000,27642.27642276423,-50,-1463000
2022,county,48439,Tarrant,48373,Polk,TX,Rural Texas,35,2538000,72514.28571428571,107,4861000,45429.90654205607,-72,-2323000
2022,county,48113,Dallas,19153,Polk,IA,Rural Iowa,135,5157000,38200.0,51,1697000,33274.509803921566,84,3460000
2022,county,48113,Dallas,12105,Polk,FL,Orlando,94,2780000,29574.468085106382,113,3991000,35318.58407079646,-19,-1211000
2022,county,48121,Denton,12105,Polk,FL,Orlando,63,1906000,30253.968253968254,67,2861000,42701.49253731343,-4,-955000
2022,county,48121,Denton,48373,Polk,TX,Rural Texas,54,2194000,40629.62962962963,70,3799000,54271.42857142857,-16,-1605000
2022,county,48085,Collin,12105,Polk,FL,Orlando,49,1228000,25061.224489795917,70,3427000,48957.142857142855,-21,-2199000
2022,county,48439,Tarrant,48375,Potter,TX,Rural Texas,150,3753000,25020.0,94,4096000,43574.46808510638,56,-343000
2022,county,48113,Dallas,48375,Potter,TX,Rural Texas,104,4124000,39653.846153846156,97,2630000,27113.40206185567,7,1494000
2022,county,48085,Collin,48375,Potter,TX,Rural Texas,56,1601000,28589.285714285714,31,1519000,49000.0,25,82000
2022,county,48439,Tarrant,24033,Prince George,MD,Rural Maryland,110,3903000,35481.818181818184,81,2676000,33037.03703703704,29,1227000
2022,county,48113,Dallas,24033,Prince George,MD,Rural Maryland,159,6592000,41459.11949685535,106,3116000,29396.22641509434,53,3476000
2022,county,48085,Collin,24033,Prince George,MD,Rural Maryland,107,5334000,49850.46728971963,39,1529000,39205.1282051282,68,3805000
2022,county,48439,Tarrant,51153,Prince William,VA,Rural Virginia,112,4212000,37607.142857142855,64,2110000,32968.75,48,2102000
2022,county,48113,Dallas,51153,Prince William,VA,Rural Virginia,82,2810000,34268.29268292683,52,1722000,33115.38461538462,30,1088000
2022,county,48085,Collin,51153,Prince William,VA,Rural Virginia,80,3065000,38312.5,57,1875000,32894.73684210526,23,1190000
2022,county,48439,Tarrant,05119,Pulaski,AR,Little Rock,330,7702000,23339.39393939394,216,5751000,26625.0,114,1951000
2022,county,48113,Dallas,05119,Pulaski,AR,Little Rock,403,11691000,29009.925558312654,273,13407000,49109.89010989011,130,-1716000
2022,county,48121,Denton,05119,Pulaski,AR,Little Rock,150,5346000,35640.0,118,3433000,29093.22033898305,32,1913000
2022,county,48085,Collin,05119,Pulaski,AR,Little Rock,163,6338000,38883.43558282209,108,3786000,35055.555555555555,55,2552000
2022,county,48439,Tarrant,36081,Queens,NY,New York,393,16680000,42442.748091603054,85,3395000,39941.17647058824,308,13285000
2022,county,48113,Dallas,36081,Queens,NY,New York,383,18248000,47644.90861618799,99,5101000,51525.25252525252,284,13147000
2022,county,48121,Denton,36081,Queens,NY,New York,199,9700000,48743.718592964826,38,1305000,34342.10526315789,161,8395000
2022,county,48085,Collin,36081,Queens,NY,New York,314,17164000,54662.420382165605,73,3477000,47630.13698630137,241,13687000
2022,county,48439,Tarrant,27123,Ramsey,MN,Minneapolis,48,1724000,35916.666666666664,50,998000,19960.0,-2,726000
2022,county,48113,Dallas,27123,Ramsey,MN,Minneapolis,116,2993000,25801.724137931036,66,2336000,35393.93939393939,50,657000
2022,county,48439,Tarrant,48381,Randall,TX,Rural Texas,219,7687000,35100.45662100457,152,5165000,33980.26315789474,67,2522000
2022,county,48113,Dallas,48381,Randall,TX,Rural Texas,115,4655000,40478.260869565216,95,3735000,39315.78947368421,20,920000
2022,county,48121,Denton,48381,Randall,TX,Rural Texas,110,3549000,32263.636363636364,66,2424000,36727.27272727273,44,1125000
2022,county,48085,Collin,48381,Randall,TX,Rural Texas,105,5108000,48647.619047619046,92,4638000,50413.04347826087,13,470000
2022,county,48439,Tarrant,22079,Rapides Parish,LA,Rural Louisiana,90,1948000,21644.444444444445,48,767000,15979.166666666666,42,1181000
2022,county,48113,Dallas,22079,Rapides Parish,LA,Rural Louisiana,94,1935000,20585.106382978724,45,877000,19488.88888888889,49,1058000
2022,county,48113,Dallas,45079,Richland,SC,Columbia,62,3165000,51048.3870967742,56,2363000,42196.42857142857,6,802000
2022,county,48113,Dallas,13245,Richmond,GA,Rural Georgia,52,1508000,29000.0,24,1242000,51750.0,28,266000
2022,county,48113,Dallas,51760,Richmond city,VA,Richmond,27,2667000,98777.77777777778,29,3118000,107517.24137931035,-2,-451000
2022,county,48439,Tarrant,06065,Riverside,CA,San Bernardino-Riverside,737,28936000,39261.8724559023,189,6970000,36878.30687830688,548,21966000
2022,county,48113,Dallas,06065,Riverside,CA,San Bernardino-Riverside,341,14430000,42316.715542522,210,13607000,64795.23809523809,131,823000
2022,county,48121,Denton,06065,Riverside,CA,San Bernardino-Riverside,411,16621000,40440.389294403896,101,5388000,53346.53465346534,310,11233000
2022,county,48085,Collin,06065,Riverside,CA,San Bernardino-Riverside,487,21934000,45039.01437371663,164,9396000,57292.68292682927,323,12538000
2022,county,48439,Tarrant,48397,Rockwall,TX,Dallas-Fort Worth,230,8829000,38386.95652173913,436,17392000,39889.908256880735,-206,-8563000
2022,county,48113,Dallas,48397,Rockwall,TX,Dallas-Fort Worth,1859,84250000,45320.064550833784,4727,216716000,45846.41421620478,-2868,-132466000
2022,county,48121,Denton,48397,Rockwall,TX,Dallas-Fort Worth,209,10716000,51272.72727272727,562,25030000,44537.36654804271,-353,-14314000
2022,county,48085,Collin,48397,Rockwall,TX,Dallas-Fort Worth,1280,45378000,35451.5625,1806,71300000,39479.51273532669,-526,-25922000
2022,county,48439,Tarrant,48401,Rusk,TX,Rural Texas,49,809000,16510.20408163265,79,1993000,25227.848101265823,-30,-1184000
2022,county,48113,Dallas,48401,Rusk,TX,Rural Texas,57,1553000,27245.614035087718,75,1282000,17093.333333333332,-18,271000
2022,county,48439,Tarrant,47149,Rutherford,TN,Nashville,46,1568000,34086.95652173913,63,1945000,30873.015873015873,-17,-377000
2022,county,48113,Dallas,47149,Rutherford,TN,Nashville,52,1563000,30057.69230769231,61,4456000,73049.18032786885,-9,-2893000
2022,county,48085,Collin,47149,Rutherford,TN,Nashville,54,1734000,32111.11111111111,54,3863000,71537.03703703704,0,-2129000
2022,county,48439,Tarrant,06067,Sacramento,CA,Sacramento,273,15195000,55659.34065934066,87,2727000,31344.827586206895,186,12468000
2022,county,48113,Dallas,06067,Sacramento,CA,Sacramento,236,18534000,78533.89830508475,111,5888000,53045.045045045044,125,12646000
2022,county,48121,Denton,06067,Sacramento,CA,Sacramento,155,6571000,42393.54838709677,38,1656000,43578.94736842105,117,4915000
2022,county,48085,Collin,06067,Sacramento,CA,Sacramento,194,11929000,61489.69072164949,68,2789000,41014.705882352944,126,9140000
2022,county,48439,Tarrant,05125,Saline,AR,Little Rock,55,2421000,44018.181818181816,63,3494000,55460.31746031746,-8,-1073000
2022,county,48121,Denton,05125,Saline,AR,Little Rock,42,1209000,28785.714285714286,44,2417000,54931.818181818184,-2,-1208000
2022,county,48439,Tarrant,49035,Salt Lake,UT,Salt Lake,212,7985000,37665.09433962264,129,5632000,43658.91472868217,83,2353000
2022,county,48113,Dallas,49035,Salt Lake,UT,Salt Lake,247,12820000,51902.83400809717,159,10492000,65987.4213836478,88,2328000
2022,county,48121,Denton,49035,Salt Lake,UT,Salt Lake,127,5314000,41842.51968503937,95,3586000,37747.36842105263,32,1728000
2022,county,48085,Collin,49035,Salt Lake,UT,Salt Lake,211,10857000,51454.97630331753,153,6872000,44915.032679738564,58,3985000
2022,county,48439,Tarrant,06071,San Bernardino,CA,San Bernardino-Riverside,596,22836000,38315.43624161074,199,7237000,36366.83417085427,397,15599000
2022,county,48113,Dallas,06071,San Bernardino,CA,San Bernardino-Riverside,362,11058000,30546.96132596685,145,3677000,25358.620689655174,217,7381000
2022,county,48121,Denton,06071,San Bernardino,CA,San Bernardino-Riverside,340,14612000,42976.470588235294,52,2031000,39057.692307692305,288,12581000
2022,county,48085,Collin,06071,San Bernardino,CA,San Bernardino-Riverside,485,20027000,41292.78350515464,75,2526000,33680.0,410,17501000
2022,county,48439,Tarrant,06073,San Diego,CA,San Diego,1020,48429000,47479.41176470588,414,16187000,39099.03381642512,606,32242000
2022,county,48113,Dallas,06073,San Diego,CA,San Diego,808,67595000,83657.17821782178,472,27566000,58402.542372881355,336,40029000
2022,county,48121,Denton,06073,San Diego,CA,San Diego,708,34648000,48937.853107344636,228,12214000,53570.17543859649,480,22434000
2022,county,48085,Collin,06073,San Diego,CA,San Diego,796,43425000,54554.020100502516,361,26712000,73994.45983379502,435,16713000
2022,county,48439,Tarrant,06075,San Francisco,CA,Bay Area,78,7905000,101346.15384615384,59,3516000,59593.220338983054,19,4389000
2022,county,48113,Dallas,06075,San Francisco,CA,Bay Area,184,40583000,220559.78260869565,211,31420000,148909.95260663508,-27,9163000
2022,county,48121,Denton,06075,San Francisco,CA,Bay Area,27,2834000,104962.96296296296,30,2716000,90533.33333333333,-3,118000
2022,county,48085,Collin,06075,San Francisco,CA,Bay Area,86,13422000,156069.76744186046,76,8695000,114407.8947368421,10,4727000
2022,county,48113,Dallas,06077,San Joaquin,CA,Bay Area,106,3413000,32198.11320754717,31,1130000,36451.6129032258,75,2283000
2022,county,48439,Tarrant,06081,San Mateo,CA,Bay Area,100,13191000,131910.0,60,4508000,75133.33333333333,40,8683000
2022,county,48113,Dallas,06081,San Mateo,CA,Bay Area,151,45189000,299264.90066225163,108,15297000,141638.88888888888,43,29892000
2022,county,48085,Collin,06081,San Mateo,CA,Bay Area,116,12597000,108594.8275862069,54,4167000,77166.66666666667,62,8430000
2022,county,48439,Tarrant,48409,San Patricio,TX,Rural Texas,42,876000,20857.14285714286,42,1751000,41690.47619047619,0,-875000
2022,county,48439,Tarrant,35043,Sandoval,NM,Albuquerque,66,2782000,42151.51515151515,50,2959000,59180.0,16,-177000
2022,county,48439,Tarrant,06085,Santa Clara,CA,Bay Area,424,38737000,91360.84905660378,155,9755000,62935.48387096774,269,28982000
2022,county,48113,Dallas,06085,Santa Clara,CA,Bay Area,422,59430000,140829.38388625594,270,29151000,107966.66666666667,152,30279000
2022,county,48121,Denton,06085,Santa Clara,CA,Bay Area,350,38564000,110182.85714285714,119,10363000,87084.03361344538,231,28201000
2022,county,48085,Collin,06085,Santa Clara,CA,Bay Area,833,105663000,126846.33853541416,376,36356000,96691.48936170213,457,69307000
2022,county,48113,Dallas,35049,Santa Fe,NM,Rural New Mexico,49,3244000,66204.08163265306,72,10992000,152666.66666666666,-23,-7748000
2022,county,48439,Tarrant,12113,Santa Rosa,FL,FL Panhandle,43,1362000,31674.418604651164,45,2358000,52400.0,-2,-996000
2022,county,48439,Tarrant,12115,Sarasota,FL,S.W. Florida,43,2159000,50209.3023255814,60,3353000,55883.333333333336,-17,-1194000
2022,county,48113,Dallas,12115,Sarasota,FL,S.W. Florida,36,1313000,36472.22222222222,50,8355000,167100.0,-14,-7042000
2022,county,48439,Tarrant,05131,Sebastian,AR,Rural Arkansas,41,1395000,34024.39024390244,47,1732000,36851.063829787236,-6,-337000
2022,county,48113,Dallas,05131,Sebastian,AR,Rural Arkansas,62,1706000,27516.129032258064,50,1564000,31280.0,12,142000
2022,county,48439,Tarrant,20173,Sedgwick,KS,Rural Kansas,246,7615000,30955.28455284553,195,5874000,30123.076923076922,51,1741000
2022,county,48113,Dallas,20173,Sedgwick,KS,Rural Kansas,187,8412000,44983.95721925134,141,7734000,54851.063829787236,46,678000
2022,county,48121,Denton,20173,Sedgwick,KS,Rural Kansas,90,3790000,42111.11111111111,95,3919000,41252.63157894737,-5,-129000
2022,county,48085,Collin,20173,Sedgwick,KS,Rural Kansas,133,5322000,40015.03759398496,64,1848000,28875.0,69,3474000
2022,county,48439,Tarrant,12117,Seminole,FL,Orlando,59,1583000,26830.508474576272,70,2342000,33457.142857142855,-11,-759000
2022,county,48113,Dallas,12117,Seminole,FL,Orlando,60,2795000,46583.333333333336,74,2823000,38148.64864864865,-14,-28000
2022,county,48121,Denton,12117,Seminole,FL,Orlando,53,2557000,48245.28301886792,43,2332000,54232.558139534885,10,225000
2022,county,48085,Collin,12117,Seminole,FL,Orlando,65,2913000,44815.38461538462,56,2823000,50410.71428571428,9,90000
2022,county,48439,Tarrant,47157,Shelby,TN,Memphis,458,10314000,22519.650655021833,182,5596000,30747.252747252747,276,4718000
2022,county,48113,Dallas,47157,Shelby,TN,Memphis,498,19075000,38303.212851405624,284,18608000,65521.126760563384,214,467000
2022,county,48121,Denton,47157,Shelby,TN,Memphis,314,10385000,33073.24840764331,88,3726000,42340.90909090909,226,6659000
2022,county,48085,Collin,47157,Shelby,TN,Memphis,262,12467000,47583.96946564886,88,4528000,51454.545454545456,174,7939000
2022,county,48439,Tarrant,48423,Smith,TX,Rural Texas,418,16159000,38657.89473684211,496,18284000,36862.903225806454,-78,-2125000
2022,county,48113,Dallas,48423,Smith,TX,Rural Texas,661,19254000,29128.5930408472,713,54318000,76182.32819074334,-52,-35064000
2022,county,48121,Denton,48423,Smith,TX,Rural Texas,217,10381000,47838.709677419356,273,16917000,61967.03296703297,-56,-6536000
2022,county,48085,Collin,48423,Smith,TX,Rural Texas,323,10127000,31352.941176470587,392,19412000,49520.4081632653,-69,-9285000
2022,county,48439,Tarrant,53061,Snohomish,WA,Seattle,233,9855000,42296.13733905579,121,4333000,35809.9173553719,112,5522000
2022,county,48113,Dallas,53061,Snohomish,WA,Seattle,158,5598000,35430.379746835446,106,6378000,60169.811320754714,52,-780000
2022,county,48121,Denton,53061,Snohomish,WA,Seattle,205,13545000,66073.17073170732,39,1905000,48846.153846153844,166,11640000
2022,county,48085,Collin,53061,Snohomish,WA,Seattle,390,23384000,59958.97435897436,100,7447000,74470.0,290,15937000
2022,county,48439,Tarrant,06095,Solano,CA,Bay Area,97,4455000,45927.83505154639,37,999000,27000.0,60,3456000
2022,county,48113,Dallas,34035,Somerset,NJ,New York,100,7326000,73260.0,33,2301000,69727.27272727272,67,5025000
2022,county,48439,Tarrant,48425,Somervell,TX,Rural Texas,63,1997000,31698.4126984127,133,8492000,63849.624060150374,-70,-6495000
2022,county,48439,Tarrant,09170,South Central CT Planning Region,CT,New Haven,53,1782000,33622.64150943396,30,991000,33033.333333333336,23,791000
2022,county,48113,Dallas,09170,South Central CT Planning Region,CT,New Haven,63,2508000,39809.52380952381,34,1683000,49500.0,29,825000
2022,county,48439,Tarrant,53063,Spokane,WA,Spokane,111,3550000,31981.981981981982,61,1828000,29967.213114754097,50,1722000
2022,county,48113,Dallas,53063,Spokane,WA,Spokane,52,1781000,34250.0,37,2218000,59945.94594594595,15,-437000
2022,county,48439,Tarrant,29183,St. Charles,MO,St. Louis,93,3076000,33075.2688172043,45,2692000,59822.22222222222,48,384000
2022,county,48113,Dallas,29183,St. Charles,MO,St. Louis,68,2820000,41470.58823529412,55,2405000,43727.27272727273,13,415000
2022,county,48121,Denton,29183,St. Charles,MO,St. Louis,56,4747000,84767.85714285714,34,2321000,68264.70588235294,22,2426000
2022,county,48085,Collin,29183,St. Charles,MO,St. Louis,48,2630000,54791.666666666664,42,2865000,68214.28571428571,6,-235000
2022,county,48439,Tarrant,17163,St. Clair,IL,St. Louis,43,1038000,24139.53488372093,47,1521000,32361.702127659573,-4,-483000
2022,county,48439,Tarrant,12109,St. Johns,FL,Jacksonville,51,1137000,22294.117647058825,48,5709000,118937.5,3,-4572000
2022,county,48439,Tarrant,18141,St. Joseph,IN,Rural Indiana,43,1800000,41860.46511627907,34,985000,28970.58823529412,9,815000
2022,county,48113,Dallas,18141,St. Joseph,IN,Rural Indiana,32,1195000,37343.75,36,1747000,48527.77777777778,-4,-552000
2022,county,48439,Tarrant,29189,St. Louis,MO,St. Louis,264,9063000,34329.545454545456,153,5827000,38084.967320261436,111,3236000
2022,county,48113,Dallas,29189,St. Louis,MO,St. Louis,380,19711000,51871.05263157895,174,10408000,59816.09195402299,206,9303000
2022,county,48121,Denton,29189,St. Louis,MO,St. Louis,209,11298000,54057.416267942586,94,4687000,49861.70212765958,115,6611000
2022,county,48085,Collin,29189,St. Louis,MO,St. Louis,331,17802000,53782.47734138973,108,6880000,63703.7037037037,223,10922000
2022,county,48439,Tarrant,29510,St. Louis city,MO,Rural Missouri,68,2027000,29808.823529411766,50,1021000,20420.0,18,1006000
2022,county,48113,Dallas,29510,St. Louis city,MO,Rural Missouri,270,47843000,177196.2962962963,49,2764000,56408.163265306124,221,45079000
2022,county,48121,Denton,29510,St. Louis city,MO,Rural Missouri,49,1680000,34285.71428571428,36,1254000,34833.333333333336,13,426000
2022,county,48113,Dallas,12111,St. Lucie,FL,Atlantic Coast,26,737000,28346.153846153848,41,1287000,31390.243902439026,-15,-550000
2022,county,48439,Tarrant,22103,St. Tammany Parish,LA,New Orleans,42,1366000,32523.809523809523,79,3585000,45379.74683544304,-37,-2219000
2022,county,48113,Dallas,22103,St. Tammany Parish,LA,New Orleans,70,2319000,33128.57142857143,40,2994000,74850.0,30,-675000
2022,county,48439,Tarrant,36103,Suffolk,NY,New York,107,5252000,49084.11214953271,42,1259000,29976.190476190477,65,3993000
2022,county,48439,Tarrant,25025,Suffolk,MA,Boston,61,2966000,48622.95081967213,48,1920000,40000.0,13,1046000
2022,county,48113,Dallas,25025,Suffolk,MA,Boston,299,49348000,165043.47826086957,136,9948000,73147.05882352941,163,39400000
2022,county,48113,Dallas,36103,Suffolk,NY,New York,176,11036000,62704.545454545456,59,7103000,120389.83050847458,117,3933000
2022,county,48121,Denton,25025,Suffolk,MA,Boston,54,2545000,47129.62962962963,35,3027000,86485.71428571429,19,-482000
2022,county,48085,Collin,25025,Suffolk,MA,Boston,76,6079000,79986.84210526316,53,4013000,75716.98113207547,23,2066000
2022,county,48439,Tarrant,39153,Summit,OH,Rural Ohio,36,1373000,38138.88888888889,55,1670000,30363.636363636364,-19,-297000
2022,county,48113,Dallas,39153,Summit,OH,Rural Ohio,52,1943000,37365.38461538462,48,1542000,32125.0,4,401000
2022,county,48113,Dallas,48439,Tarrant,TX,Dallas-Fort Worth,18231,642173000,35224.23344852175,23958,1180219000,49262.000166958846,-5727,-538046000
2022,county,48121,Denton,48439,Tarrant,TX,Dallas-Fort Worth,10098,520440000,51538.91859774213,8006,340745000,42561.20409692731,2092,179695000
2022,county,48085,Collin,48439,Tarrant,TX,Dallas-Fort Worth,3262,150464000,46126.30288166769,3266,157162000,48120.63686466626,-4,-6698000
2022,county,48439,Tarrant,48441,Taylor,TX,Rural Texas,370,9958000,26913.513513513513,358,9621000,26874.301675977655,12,337000
2022,county,48113,Dallas,48441,Taylor,TX,Rural Texas,257,7369000,28673.151750972764,187,5999000,32080.213903743315,70,1370000
2022,county,48121,Denton,48441,Taylor,TX,Rural Texas,142,4022000,28323.943661971833,89,2745000,30842.696629213482,53,1277000
2022,county,48085,Collin,48441,Taylor,TX,Rural Texas,112,4317000,38544.642857142855,110,3264000,29672.727272727272,2,1053000
2022,county,48439,Tarrant,53067,Thurston,WA,Rural Washington,58,1579000,27224.137931034482,30,1433000,47766.666666666664,28,146000
2022,county,48113,Dallas,53067,Thurston,WA,Rural Washington,49,1405000,28673.469387755104,38,1660000,43684.21052631579,11,-255000
2022,county,48121,Denton,53067,Thurston,WA,Rural Washington,60,2527000,42116.666666666664,52,1950000,37500.0,8,577000
2022,county,48113,Dallas,48449,Titus,TX,Rural Texas,54,1054000,19518.51851851852,67,1995000,29776.119402985074,-13,-941000
2022,county,48439,Tarrant,48451,Tom Green,TX,Rural Texas,176,5357000,30437.5,101,2485000,24603.960396039605,75,2872000
2022,county,48113,Dallas,48451,Tom Green,TX,Rural Texas,84,4181000,49773.80952380953,71,2407000,33901.40845070423,13,1774000
2022,county,48121,Denton,48451,Tom Green,TX,Rural Texas,56,2192000,39142.857142857145,74,3680000,49729.72972972973,-18,-1488000
2022,county,48085,Collin,48451,Tom Green,TX,Rural Texas,62,1802000,29064.516129032258,44,1404000,31909.090909090908,18,398000
2022,county,48439,Tarrant,48453,Travis,TX,Austin,1300,73344000,56418.46153846154,1095,69457000,63431.0502283105,205,3887000
2022,county,48113,Dallas,48453,Travis,TX,Austin,1878,164630000,87662.40681576145,2222,198801000,89469.39693969396,-344,-34171000
2022,county,48121,Denton,48453,Travis,TX,Austin,699,39704000,56801.144492131614,701,65129000,92908.70185449359,-2,-25425000
2022,county,48085,Collin,48453,Travis,TX,Austin,990,84486000,85339.39393939394,971,76201000,78476.8280123584,19,8285000
2022,county,48439,Tarrant,40143,Tulsa,OK,Tulsa,307,12153000,39586.31921824104,309,11009000,35627.831715210355,-2,1144000
2022,county,48113,Dallas,40143,Tulsa,OK,Tulsa,374,14592000,39016.04278074866,368,14981000,40709.239130434784,6,-389000
2022,county,48121,Denton,40143,Tulsa,OK,Tulsa,190,11070000,58263.15789473684,219,8788000,40127.85388127854,-29,2282000
2022,county,48085,Collin,40143,Tulsa,OK,Tulsa,229,12609000,55061.135371179036,230,10159000,44169.565217391304,-1,2450000
2022,county,48113,Dallas,48459,Upshur,TX,Rural Texas,41,1446000,35268.29268292683,72,3075000,42708.333333333336,-31,-1629000
2022,county,48439,Tarrant,49049,Utah,UT,Rural Utah,151,4052000,26834.437086092716,92,4883000,53076.086956521736,59,-831000
2022,county,48113,Dallas,49049,Utah,UT,Rural Utah,115,5423000,47156.52173913043,86,6245000,72616.27906976744,29,-822000
2022,county,48121,Denton,49049,Utah,UT,Rural Utah,138,6817000,49398.55072463768,138,4461000,32326.08695652174,0,2356000
2022,county,48085,Collin,49049,Utah,UT,Rural Utah,227,6610000,29118.942731277533,138,9138000,66217.39130434782,89,-2528000
2022,county,48439,Tarrant,48465,Val Verde,TX,Rural Texas,52,803000,15442.307692307691,67,1118000,16686.567164179105,-15,-315000
2022,county,48439,Tarrant,48467,Van Zandt,TX,Rural Texas,62,2547000,41080.645161290326,145,6023000,41537.93103448276,-83,-3476000
2022,county,48113,Dallas,48467,Van Zandt,TX,Rural Texas,251,7186000,28629.482071713148,726,20840000,28705.234159779615,-475,-13654000
2022,county,48121,Denton,48467,Van Zandt,TX,Rural Texas,30,1666000,55533.333333333336,129,6516000,50511.62790697674,-99,-4850000
2022,county,48085,Collin,48467,Van Zandt,TX,Rural Texas,58,1895000,32672.41379310345,145,6291000,43386.206896551725,-87,-4396000
2022,county,48439,Tarrant,06111,Ventura,CA,Los Angeles,190,9333000,49121.05263157895,104,2741000,26355.76923076923,86,6592000
2022,county,48113,Dallas,06111,Ventura,CA,Los Angeles,186,12351000,66403.2258064516,48,4883000,101729.16666666667,138,7468000
2022,county,48121,Denton,06111,Ventura,CA,Los Angeles,162,13784000,85086.41975308642,51,3460000,67843.13725490196,111,10324000
2022,county,48085,Collin,06111,Ventura,CA,Los Angeles,245,10887000,44436.73469387755,31,1415000,45645.16129032258,214,9472000
2022,county,48113,Dallas,48469,Victoria,TX,Rural Texas,35,960000,27428.571428571428,49,893000,18224.48979591837,-14,67000
2022,county,48439,Tarrant,51810,Virginia Beach city,VA,Hampton Roads,134,3467000,25873.13432835821,87,3443000,39574.71264367816,47,24000
2022,county,48113,Dallas,51810,Virginia Beach city,VA,Hampton Roads,95,3286000,34589.47368421053,85,3113000,36623.529411764706,10,173000
2022,county,48439,Tarrant,12127,Volusia,FL,Atlantic Coast,52,1766000,33961.53846153846,64,2909000,45453.125,-12,-1143000
2022,county,48113,Dallas,12127,Volusia,FL,Atlantic Coast,43,1837000,42720.93023255814,68,4965000,73014.70588235294,-25,-3128000
2022,county,48439,Tarrant,37183,Wake,NC,Raleigh,116,5921000,51043.10344827586,150,7810000,52066.666666666664,-34,-1889000
2022,county,48113,Dallas,37183,Wake,NC,Raleigh,216,13792000,63851.851851851854,228,18576000,81473.68421052632,-12,-4784000
2022,county,48121,Denton,37183,Wake,NC,Raleigh,112,7131000,63669.642857142855,149,8641000,57993.288590604025,-37,-1510000
2022,county,48085,Collin,37183,Wake,NC,Raleigh,230,12289000,53430.434782608696,185,12339000,66697.2972972973,45,-50000
2022,county,48439,Tarrant,48471,Walker,TX,Rural Texas,80,1829000,22862.5,64,2517000,39328.125,16,-688000
2022,county,48113,Dallas,48471,Walker,TX,Rural Texas,82,1773000,21621.951219512193,49,1168000,23836.73469387755,33,605000
2022,county,48113,Dallas,48473,Waller,TX,Houston,26,695000,26730.76923076923,36,1013000,28138.88888888889,-10,-318000
2022,county,48439,Tarrant,05143,Washington,AR,Rural Arkansas,99,3704000,37414.14141414141,107,5720000,53457.943925233645,-8,-2016000
2022,county,48439,Tarrant,41067,Washington,OR,Portland,115,4197000,36495.65217391304,91,3635000,39945.054945054944,24,562000
2022,county,48113,Dallas,05143,Washington,AR,Rural Arkansas,104,4454000,42826.92307692308,124,6735000,54314.51612903226,-20,-2281000
2022,county,48113,Dallas,41067,Washington,OR,Portland,159,7981000,50194.96855345912,74,4992000,67459.45945945945,85,2989000
2022,county,48113,Dallas,28151,Washington,MS,Rural Mississippi,91,947000,10406.593406593407,42,327000,7785.714285714285,49,620000
2022,county,48121,Denton,41067,Washington,OR,Portland,154,10400000,67532.46753246753,47,1913000,40702.12765957447,107,8487000
2022,county,48121,Denton,05143,Washington,AR,Rural Arkansas,51,2003000,39274.509803921566,78,2765000,35448.717948717946,-27,-762000
2022,county,48085,Collin,41067,Washington,OR,Portland,272,15661000,57577.205882352944,76,4470000,58815.78947368421,196,11191000
2022,county,48085,Collin,05143,Washington,AR,Rural Arkansas,60,2363000,39383.333333333336,91,6580000,72307.69230769231,-31,-4217000
2022,county,48439,Tarrant,32031,Washoe,NV,Rural Nevada,113,5830000,51592.9203539823,58,3740000,64482.75862068965,55,2090000
2022,county,48113,Dallas,32031,Washoe,NV,Rural Nevada,80,4736000,59200.0,49,4993000,101897.95918367348,31,-257000
2022,county,48121,Denton,32031,Washoe,NV,Rural Nevada,47,2360000,50212.765957446805,30,1103000,36766.666666666664,17,1257000
2022,county,48439,Tarrant,26161,Washtenaw,MI,Rural Michigan,52,2686000,51653.846153846156,33,1408000,42666.666666666664,19,1278000
2022,county,48113,Dallas,26161,Washtenaw,MI,Rural Michigan,76,3575000,47039.47368421053,51,1735000,34019.60784313725,25,1840000
2022,county,48085,Collin,26161,Washtenaw,MI,Rural Michigan,49,3411000,69612.24489795919,43,1664000,38697.67441860465,6,1747000
2022,county,48439,Tarrant,26163,Wayne,MI,Detroit,245,6123000,24991.836734693876,134,3122000,23298.507462686568,111,3001000
2022,county,48113,Dallas,26163,Wayne,MI,Detroit,234,10171000,43465.81196581197,116,3609000,31112.068965517243,118,6562000
2022,county,48121,Denton,26163,Wayne,MI,Detroit,109,6031000,55330.2752293578,66,2507000,37984.84848484849,43,3524000
2022,county,48085,Collin,26163,Wayne,MI,Detroit,133,6784000,51007.51879699248,76,4174000,54921.05263157895,57,2610000
2022,county,48439,Tarrant,48479,Webb,TX,Rural Texas,131,2790000,21297.709923664122,81,2374000,29308.64197530864,50,416000
2022,county,48113,Dallas,48479,Webb,TX,Rural Texas,214,5635000,26331.77570093458,146,2839000,19445.205479452055,68,2796000
2022,county,48439,Tarrant,08123,Weld,CO,Rural Colorado,70,2189000,31271.428571428572,104,3029000,29125.0,-34,-840000
2022,county,48113,Dallas,08123,Weld,CO,Rural Colorado,41,1172000,28585.365853658535,51,1575000,30882.352941176472,-10,-403000
2022,county,48113,Dallas,36119,Westchester,NY,New York,91,4966000,54571.42857142857,35,2242000,64057.142857142855,56,2724000
2022,county,48113,Dallas,09190,Western Connecticut,CT,New York,150,19392000,129280.0,48,6724000,140083.33333333334,102,12668000
2022,county,48439,Tarrant,48485,Wichita,TX,Rural Texas,420,14013000,33364.28571428572,299,13237000,44270.90301003344,121,776000
2022,county,48113,Dallas,48485,Wichita,TX,Rural Texas,221,9449000,42755.656108597286,232,7740000,33362.06896551724,-11,1709000
2022,county,48121,Denton,48485,Wichita,TX,Rural Texas,166,5573000,33572.2891566265,161,4824000,29962.732919254657,5,749000
2022,county,48085,Collin,48485,Wichita,TX,Rural Texas,134,5325000,39738.80597014925,90,3198000,35533.333333333336,44,2127000
2022,county,48439,Tarrant,17197,Will,IL,Chicago,161,5202000,32310.55900621118,35,1287000,36771.42857142857,126,3915000
2022,county,48113,Dallas,17197,Will,IL,Chicago,136,10773000,79213.23529411765,65,3874000,59600.0,71,6899000
2022,county,48121,Denton,17197,Will,IL,Chicago,123,7929000,64463.41463414634,44,1435000,32613.636363636364,79,6494000
2022,county,48439,Tarrant,48491,Williamson,TX,Austin,619,29120000,47043.61873990307,582,29193000,50159.79381443299,37,-73000
2022,county,48113,Dallas,48491,Williamson,TX,Austin,545,25700000,47155.963302752294,752,53798000,71539.89361702128,-207,-28098000
2022,county,48113,Dallas,47187,Williamson,TN,Nashville,55,3686000,67018.18181818182,70,6289000,89842.85714285714,-15,-2603000
2022,county,48121,Denton,48491,Williamson,TX,Austin,439,22922000,52214.12300683371,408,29775000,72977.94117647059,31,-6853000
2022,county,48085,Collin,48491,Williamson,TX,Austin,570,33655000,59043.85964912281,608,44758000,73615.13157894737,-38,-11103000
2022,county,48085,Collin,47187,Williamson,TN,Nashville,85,4377000,51494.117647058825,64,4645000,72578.125,21,-268000
2022,county,48439,Tarrant,48497,Wise,TX,Dallas-Fort Worth,997,34703000,34807.4222668004,2372,84360000,35564.924114671165,-1375,-49657000
2022,county,48113,Dallas,48497,Wise,TX,Dallas-Fort Worth,114,4739000,41570.17543859649,231,8732000,37800.8658008658,-117,-3993000
2022,county,48121,Denton,48497,Wise,TX,Dallas-Fort Worth,507,21932000,43258.382642998025,1119,44763000,40002.680965147454,-612,-22831000
2022,county,48085,Collin,48497,Wise,TX,Dallas-Fort Worth,53,2079000,39226.41509433962,139,5273000,37935.25179856115,-86,-3194000
2022,county,48439,Tarrant,48499,Wood,TX,Rural Texas,74,2997000,40500.0,187,7221000,38614.97326203209,-113,-4224000
2022,county,48113,Dallas,48499,Wood,TX,Rural Texas,121,9459000,78173.55371900827,254,12490000,49173.22834645669,-133,-3031000
2022,county,48121,Denton,48499,Wood,TX,Rural Texas,37,831000,22459.45945945946,159,7605000,47830.188679245286,-122,-6774000
2022,county,48085,Collin,48499,Wood,TX,Rural Texas,70,2121000,30300.0,180,11139000,61883.333333333336,-110,-9018000
2022,county,48439,Tarrant,25027,Worcester,MA,Rural Massachusetts,59,1831000,31033.898305084746,39,1377000,35307.692307692305,20,454000
2022,county,48113,Dallas,25027,Worcester,MA,Rural Massachusetts,92,5090000,55326.086956521736,27,1669000,61814.81481481482,65,3421000
2022,county,48439,Tarrant,48503,Young,TX,Rural Texas,53,2171000,40962.264150943396,98,4679000,47744.897959183676,-45,-2508000
2022,total,48439,Tarrant,96000,,,,110906,4881184000,44011.90197103854,106320,4390847000,41298.410458991726,4586,490337000
2022,total,48113,Dallas,96000,,,,122896,6849029000,55730.28414268976,146728,7666779000,52251.64249495666,-23832,-817750000
2022,total,48121,Denton,96000,,,,82860,4636038000,55950.253439536566,65182,3268966000,50151.36080513025,17678,1367072000
2022,total,48085,Collin,96000,,,,94707,5075570000,53592.342699061315,72824,4204937000,57741.08810282325,21883,870633000
